Z,N,A,magicZ,magicN,Z_valence,N_valence,pair,jejari,permukaan,|N-Z|,EB
8,8,16,0,0,0,0,8,2.5198421,6.349604208,0,127.6193152
8,9,17,0,0,0,1,6,2.571281591,6.611489018,1,131.7623947
9,8,17,0,0,1,0,3,2.571281591,6.611489018,1,128.2195828
8,10,18,0,0,0,2,9,2.620741394,6.868285455,2,139.8077658
9,9,18,0,0,1,1,1,2.620741394,6.868285455,0,137.3694894
10,8,18,0,0,2,0,7,2.620741394,6.868285455,2,132.1426386
8,11,19,0,0,0,3,6,2.668401649,7.120367359,3,143.7634088
9,10,19,0,0,1,2,4,2.668401649,7.120367359,1,147.8013648
10,9,19,0,0,2,1,5,2.668401649,7.120367359,1,143.7795189
11,8,19,0,0,3,0,3,2.668401649,7.120367359,3,131.8198416
8,12,20,0,0,0,4,9,2.714417617,7.368062997,4,151.371414
9,11,20,0,0,1,3,2,2.714417617,7.368062997,2,154.402702
10,10,20,0,0,2,2,8,2.714417617,7.368062997,0,160.644824
11,9,20,0,0,3,1,0,2.714417617,7.368062997,2,145.970056
12,8,20,0,0,4,0,7,2.714417617,7.368062997,4,134.560504
8,13,21,0,0,0,5,6,2.758924176,7.611662611,5,155.1768687
9,12,21,0,0,1,4,4,2.758924176,7.611662611,3,162.5041614
10,11,21,0,0,2,3,6,2.758924176,7.611662611,1,167.4059856
11,10,21,0,0,3,2,3,2.758924176,7.611662611,1,163.0767201
12,9,21,0,0,4,1,5,2.758924176,7.611662611,3,149.2056657
9,13,22,0,0,1,5,2,2.802039331,7.851424411,4,167.7344988
10,12,22,0,0,2,4,9,2.802039331,7.851424411,2,177.7702432
11,11,22,0,0,3,3,1,2.802039331,7.851424411,0,174.1445728
12,10,22,0,0,4,2,7,2.802039331,7.851424411,2,168.580819
10,13,23,0,0,2,5,6,2.84386698,8.087579399,3,182.9708903
11,12,23,0,0,3,4,4,2.84386698,8.087579399,1,186.5643528
12,11,23,0,0,4,3,5,2.84386698,8.087579399,1,181.7258267
13,10,23,0,0,5,2,3,2.84386698,8.087579399,3,168.7217325
10,14,24,0,0,2,6,9,2.884499141,8.320335292,4,191.8398048
11,13,24,0,0,3,5,2,2.884499141,8.320335292,2,193.5237168
12,12,24,0,0,4,4,8,2.884499141,8.320335292,0,198.2570472
13,11,24,0,0,5,3,0,2.884499141,8.320335292,2,183.5899344
14,10,24,0,0,6,2,7,2.884499141,8.320335292,4,172.0135896
11,14,25,0,0,3,6,4,2.924017738,8.549879733,3,202.5349475
12,13,25,0,0,4,5,6,2.924017738,8.549879733,1,205.58757
13,12,25,0,0,5,4,3,2.924017738,8.549879733,1,200.528415
14,11,25,0,0,6,3,5,2.924017738,8.549879733,3,187.0027725
10,16,26,0,0,2,8,9,2.962496068,8.776382955,6,201.549686
11,15,26,0,0,3,7,2,2.962496068,8.776382955,4,208.1092338
12,14,26,0,0,4,6,9,2.962496068,8.776382955,2,216.6806486
13,13,26,0,0,5,5,1,2.962496068,8.776382955,0,211.8938978
14,12,26,0,0,6,4,7,2.962496068,8.776382955,2,206.0424158
11,16,27,0,0,3,8,4,3,9,5,214.8375609
12,15,27,0,0,4,7,6,3,9,3,223.1240175
13,14,27,0,0,5,6,4,3,9,1,224.9519391
14,13,27,0,0,6,5,5,3,9,1,219.357234
15,12,27,0,0,7,4,3,3,9,3,206.8494138
11,17,28,0,0,3,9,2,3.036588972,9.220872584,6,218.3794032
12,16,28,0,0,4,8,9,3.036588972,9.220872584,4,231.6286868
13,15,28,0,0,5,7,2,3.036588972,9.220872584,2,232.6771132
14,14,28,0,0,6,6,8,3.036588972,9.220872584,0,236.536846
15,13,28,0,0,7,5,0,3.036588972,9.220872584,2,221.4095576
11,18,29,0,0,3,10,4,3.072316826,9.439130677,7,222.7824138
12,17,29,0,0,4,9,6,3.072316826,9.439130677,5,235.2924193
13,16,29,0,0,5,8,4,3.072316826,9.439130677,3,242.1054763
14,15,29,0,0,6,7,6,3.072316826,9.439130677,1,245.0104469
15,14,29,0,0,7,6,3,3.072316826,9.439130677,1,239.2858672
16,13,29,0,0,8,5,5,3.072316826,9.439130677,3,224.6450954
11,19,30,0,0,3,11,2,3.107232506,9.654893846,8,225.059055
12,18,30,0,0,4,10,9,3.107232506,9.654893846,6,241.63275
13,17,30,0,0,5,9,2,3.107232506,9.654893846,4,247.833147
14,16,30,0,0,6,8,9,3.107232506,9.654893846,2,255.619647
15,15,30,0,0,7,7,1,3.107232506,9.654893846,0,250.605192
16,14,30,0,0,8,6,7,3.107232506,9.654893846,2,243.681243
17,13,30,0,0,9,5,0,3.107232506,9.654893846,4,224.165094
11,20,31,0,1,3,0,4,3.141380652,9.868272403,9,229.3590118
12,19,31,0,0,4,11,6,3.141380652,9.868272403,7,243.9448466
13,18,31,0,0,5,10,4,3.141380652,9.868272403,5,254.991058
14,17,31,0,0,6,9,6,3.141380652,9.868272403,3,262.2070396
15,16,31,0,0,7,8,4,3.141380652,9.868272403,1,262.9161987
16,15,31,0,0,8,7,5,3.141380652,9.868272403,1,256.7358403
17,14,31,0,0,9,6,3,3.141380652,9.868272403,3,243.9455131
12,20,32,0,1,4,0,9,3.174802104,10.0793684,8,249.7229152
13,19,32,0,0,5,11,2,3.174802104,10.0793684,6,259.2110368
14,18,32,0,0,6,10,9,3.174802104,10.0793684,4,271.407008
15,17,32,0,0,7,9,2,3.174802104,10.0793684,2,270.8518496
16,16,32,0,0,8,8,8,3.174802104,10.0793684,0,271.7801632
17,15,32,0,0,9,7,0,3.174802104,10.0793684,2,258.3169856
18,14,32,0,0,10,6,7,3.174802104,10.0793684,4,246.4002848
12,21,33,0,1,4,1,6,3.20753433,10.28827648,9,252.0024606
13,20,33,0,1,5,0,4,3.20753433,10.28827648,7,264.6803676
14,19,33,0,0,6,11,6,3.20753433,10.28827648,5,275.9149668
15,18,33,0,0,7,10,4,3.20753433,10.28827648,3,280.9556409
16,17,33,0,0,8,9,6,3.20753433,10.28827648,1,280.4218032
17,16,33,0,0,9,8,3,3.20753433,10.28827648,1,274.0569381
18,15,33,0,0,10,7,5,3.20753433,10.28827648,3,261.6555447
12,22,34,0,1,4,2,9,3.239611801,10.49508462,10,256.7133246
13,21,34,0,1,5,1,2,3.239611801,10.49508462,8,267.2519204
14,20,34,0,1,6,0,9,3.239611801,10.49508462,6,283.4636406
15,19,34,0,0,7,11,2,3.239611801,10.49508462,4,287.2383104
16,18,34,0,0,8,10,9,3.239611801,10.49508462,2,291.8389524
17,17,34,0,0,9,9,1,3.239611801,10.49508462,0,285.5650004
18,16,34,0,0,10,8,7,3.239611801,10.49508462,2,278.7208616
13,22,35,0,1,5,2,4,3.27106631,10.69987481,9,272.5493505
15,20,35,0,1,7,0,4,3.27106631,10.69987481,5,295.618736
16,19,35,0,0,8,11,6,3.27106631,10.69987481,3,298.8247885
17,18,35,0,0,9,10,4,3.27106631,10.69987481,1,298.209765
18,17,35,0,0,10,9,5,3.27106631,10.69987481,1,291.4611735
19,16,35,0,0,11,8,3,3.27106631,10.69987481,3,278.8044315
15,21,36,0,1,7,1,2,3.301927249,10.90272356,6,299.0832912
16,20,36,0,1,8,0,9,3.301927249,10.90272356,4,308.71404
17,19,36,0,0,9,11,2,3.301927249,10.90272356,2,306.7895592
18,18,36,0,0,10,10,8,3.301927249,10.90272356,0,306.7167456
19,17,36,0,0,11,9,0,3.301927249,10.90272356,2,293.1200388
16,21,37,0,1,8,1,6,3.332221852,11.10370247,5,313.0176431
17,20,37,0,1,9,0,4,3.332221852,11.10370247,3,317.1004192
18,19,37,0,0,10,11,6,3.332221852,11.10370247,1,315.5042022
19,18,37,0,0,11,10,3,3.332221852,11.10370247,1,308.574376
20,17,37,1,0,0,9,5,3.332221852,11.10370247,3,296.1278979
16,22,38,0,1,8,2,9,3.361975407,11.30287864,6,321.0537502
17,21,38,0,1,9,1,2,3.361975407,11.30287864,4,323.2083046
18,20,38,0,1,10,0,9,3.361975407,11.30287864,2,327.3426666
19,19,38,0,0,11,11,1,3.361975407,11.30287864,0,320.6462534
20,18,38,1,0,0,10,7,3.361975407,11.30287864,2,313.1216492
17,22,39,0,1,9,2,4,3.391211443,11.50031505,5,331.2817248
18,21,39,0,1,10,1,6,3.391211443,11.50031505,3,333.9413532
19,20,39,0,1,11,0,4,3.391211443,11.50031505,1,333.7240062
20,19,39,1,0,0,11,5,3.391211443,11.50031505,1,326.4171729
21,18,39,1,0,1,10,3,3.391211443,11.50031505,3,312.5248425
16,24,40,0,1,8,4,9,3.419951893,11.69607095,8,333.17302
17,23,40,0,1,9,3,2,3.419951893,11.69607095,6,337.11064
18,22,40,0,1,10,2,9,3.419951893,11.69607095,4,343.810376
19,21,40,0,1,11,1,2,3.419951893,11.69607095,2,341.523628
20,20,40,1,1,0,0,8,3.419951893,11.69607095,0,342.052184
21,19,40,1,0,1,11,0,3.419951893,11.69607095,2,326.946788
16,25,41,0,1,8,5,6,3.44821724,11.89020214,9,337.4150678
18,23,41,0,1,10,3,6,3.44821724,11.89020214,5,349.9093053
19,22,41,0,1,11,2,4,3.44821724,11.89020214,3,351.6189971
20,21,41,1,1,0,1,6,3.44821724,11.89020214,1,350.4150075
21,20,41,1,1,1,0,3,3.44821724,11.89020214,1,343.1371139
22,19,41,1,0,2,11,5,3.44821724,11.89020214,3,329.4099449
16,26,42,0,1,8,6,9,3.476026645,12.08276124,10,344.115555
18,24,42,0,1,10,4,9,3.476026645,12.08276124,6,359.3357922
19,23,42,0,1,11,3,2,3.476026645,12.08276124,4,359.1527982
20,22,42,1,1,0,2,9,3.476026645,12.08276124,2,361.8957132
21,21,42,1,1,1,1,1,3.476026645,12.08276124,0,354.6870726
22,20,42,1,1,2,0,7,3.476026645,12.08276124,2,346.88808
16,27,43,0,1,8,7,6,3.50339806,12.27379797,11,346.7445868
18,25,43,0,1,10,5,6,3.50339806,12.27379797,7,364.9942426
19,24,43,0,1,11,4,4,3.50339806,12.27379797,5,368.7774772
20,23,43,1,1,0,3,6,3.50339806,12.27379797,3,369.8286079
21,22,43,1,1,1,2,4,3.50339806,12.27379797,1,366.8255395
22,21,43,1,1,2,1,5,3.50339806,12.27379797,1,359.1706322
23,20,43,1,1,3,0,3,3.50339806,12.27379797,3,346.9890547
16,28,44,0,2,8,0,9,3.530348335,12.46335937,12,351.8246776
18,26,44,0,1,10,6,9,3.530348335,12.46335937,8,373.7290084
19,25,44,0,1,11,5,2,3.530348335,12.46335937,6,376.0549012
20,24,44,1,1,0,4,9,3.530348335,12.46335937,4,380.9597836
21,23,44,1,1,1,3,2,3.530348335,12.46335937,2,376.524742
22,22,44,1,1,2,2,8,3.530348335,12.46335937,0,375.474946
23,21,44,1,1,3,1,0,3.530348335,12.46335937,2,360.9520948
18,27,45,0,1,10,7,6,3.556893304,12.65148998,9,378.897867
19,26,45,0,1,11,6,4,3.556893304,12.65148998,7,384.9603615
20,25,45,1,1,0,5,6,3.556893304,12.65148998,5,388.3746015
21,24,45,1,1,1,4,4,3.556893304,12.65148998,3,387.852345
22,23,45,1,1,2,3,6,3.556893304,12.65148998,1,385.0079445
23,22,45,1,1,3,2,3,3.556893304,12.65148998,1,377.101773
24,21,45,1,1,4,1,5,3.556893304,12.65148998,3,363.947787
18,28,46,0,2,10,0,9,3.583047871,12.83823205,10,386.969641
19,27,46,0,1,11,7,2,3.583047871,12.83823205,8,391.8299688
20,26,46,1,1,0,6,9,3.583047871,12.83823205,6,398.7733008
21,25,46,1,1,1,5,2,3.583047871,12.83823205,4,396.612989
22,24,46,1,1,2,4,9,3.583047871,12.83823205,2,398.1972658
23,23,46,1,1,3,3,1,3.583047871,12.83823205,0,390.3625458
24,22,46,1,1,4,2,7,3.583047871,12.83823205,2,381.9758718
18,29,47,0,2,10,1,6,3.60882608,13.02362568,11,390.636975
19,28,47,0,2,11,0,4,3.60882608,13.02362568,9,400.1993365
20,27,47,1,1,0,7,6,3.60882608,13.02362568,7,406.0496756
21,26,47,1,1,1,6,4,3.60882608,13.02362568,5,407.2595026
22,25,47,1,1,2,5,6,3.60882608,13.02362568,3,407.0779275
23,24,47,1,1,3,4,4,3.60882608,13.02362568,1,403.3650356
24,23,47,1,1,4,3,5,3.60882608,13.02362568,1,395.1387149
25,22,47,1,1,5,2,3,3.60882608,13.02362568,3,382.3596499
18,30,48,0,2,10,2,9,3.634241186,13.207709,12,395.6959488
19,29,48,0,2,11,1,2,3.634241186,13.207709,10,404.8431552
20,28,48,1,2,0,0,9,3.634241186,13.207709,8,416.0011968
21,27,48,1,1,1,7,2,3.634241186,13.207709,6,415.4980656
22,26,48,1,1,2,6,9,3.634241186,13.207709,4,418.7045856
23,25,48,1,1,3,5,2,3.634241186,13.207709,2,413.9072928
24,24,48,1,1,4,4,8,3.634241186,13.207709,0,411.4682544
25,23,48,1,1,5,3,0,3.634241186,13.207709,2,397.1612352
19,30,49,0,2,11,2,4,3.65930571,13.39051828,11,410.2414897
20,29,49,1,2,0,1,6,3.65930571,13.39051828,9,421.14765
21,28,49,1,2,1,0,4,3.65930571,13.39051828,7,425.6277445
22,27,49,1,1,2,7,6,3.65930571,13.39051828,5,426.8469625
23,26,49,1,1,3,6,4,3.65930571,13.39051828,3,425.4627615
24,25,49,1,1,4,5,6,3.65930571,13.39051828,1,422.0506073
25,24,49,1,1,5,4,3,3.65930571,13.39051828,1,413.555835
26,23,49,1,1,6,3,5,3.65930571,13.39051828,3,399.9042929
19,31,50,0,2,11,3,2,3.684031499,13.57208808,12,414.429165
20,30,50,1,2,0,2,9,3.684031499,13.57208808,10,427.508195
21,29,50,1,2,1,1,2,3.684031499,13.57208808,8,431.673735
22,28,50,1,2,2,0,9,3.684031499,13.57208808,6,437.786135
23,27,50,1,1,3,7,2,3.684031499,13.57208808,4,434.79516
24,26,50,1,1,4,6,9,3.684031499,13.57208808,2,435.05094
25,25,50,1,1,5,5,1,3.684031499,13.57208808,0,426.634115
26,24,50,1,1,6,4,7,3.684031499,13.57208808,2,417.70134
19,32,51,0,2,11,4,4,3.708429769,13.75245135,13,419.288085
20,31,51,1,2,0,3,6,3.708429769,13.75245135,11,432.3225885
21,30,51,1,2,1,2,4,3.708429769,13.75245135,9,438.4582863
22,29,51,1,2,2,1,6,3.708429769,13.75245135,7,444.1585512
23,28,51,1,2,3,0,4,3.708429769,13.75245135,5,445.8463452
24,27,51,1,1,4,7,6,3.708429769,13.75245135,3,444.3116073
25,26,51,1,1,5,6,4,3.708429769,13.75245135,1,440.3217702
26,25,51,1,1,6,5,5,3.708429769,13.75245135,1,431.4853827
27,24,51,1,1,7,4,3,3.708429769,13.75245135,3,417.8559999
19,33,52,0,2,11,5,2,3.732511157,13.93163954,14,421.9815756
20,32,52,1,2,0,4,9,3.732511157,13.93163954,12,438.3278692
21,31,52,1,2,1,3,2,3.732511157,13.93163954,10,443.802814
22,30,52,1,2,2,2,9,3.732511157,13.93163954,8,451.9746036
23,29,52,1,2,3,1,2,3.732511157,13.93163954,6,453.157588
24,28,52,1,2,4,0,9,3.732511157,13.93163954,4,456.3517192
25,27,52,1,1,5,7,2,3.732511157,13.93163954,2,450.8612524
26,26,52,1,1,6,6,8,3.732511157,13.93163954,0,447.6996108
27,25,52,1,1,7,5,0,3.732511157,13.93163954,2,432.9291512
20,33,53,1,2,0,5,6,3.756285754,14.10968267,13,441.5206234
21,32,53,1,2,1,4,4,3.756285754,14.10968267,11,450.1201225
22,31,53,1,2,2,3,6,3.756285754,14.10968267,9,457.4496568
23,30,53,1,2,3,2,4,3.756285754,14.10968267,7,461.6375525
24,29,53,1,2,4,1,6,3.756285754,14.10968267,5,464.2911459
25,28,53,1,2,5,0,4,3.756285754,14.10968267,3,462.9115294
26,27,53,1,1,6,7,6,3.756285754,14.10968267,1,458.3863205
27,26,53,1,1,7,6,3,3.756285754,14.10968267,1,449.3158634
28,25,53,2,1,0,5,5,3.756285754,14.10968267,3,435.5049697
20,34,54,1,2,0,6,9,3.77976315,14.28660947,14,445.3648218
21,33,54,1,2,1,5,2,3.77976315,14.28660947,12,453.859821
22,32,54,1,2,2,4,9,3.77976315,14.28660947,10,464.3833518
23,31,54,1,2,3,3,2,3.77976315,14.28660947,8,467.7554628
24,30,54,1,2,4,2,9,3.77976315,14.28660947,6,474.0102288
25,29,54,1,2,5,1,2,3.77976315,14.28660947,4,471.8507472
26,28,54,1,2,6,0,9,3.77976315,14.28660947,2,471.7647684
27,27,54,1,1,7,7,1,3.77976315,14.28660947,0,462.7378746
28,26,54,2,1,0,6,7,3.77976315,14.28660947,2,453.2237712
22,33,55,1,2,2,5,6,3.802952461,14.46244742,11,468.543328
23,32,55,1,2,3,4,4,3.802952461,14.46244742,9,475.0536505
24,31,55,1,2,4,3,6,3.802952461,14.46244742,7,480.256491
25,30,55,1,2,5,2,4,3.802952461,14.46244742,5,482.0763585
26,29,55,1,2,6,1,6,3.802952461,14.46244742,3,481.0628955
27,28,55,1,2,7,0,4,3.802952461,14.46244742,1,476.829122
28,27,55,2,1,0,7,5,3.802952461,14.46244742,1,467.3527375
24,32,56,1,2,4,4,9,3.825862366,14.63722284,8,488.5026104
25,31,56,1,2,5,3,2,3.825862366,14.63722284,6,489.3468048
26,30,56,1,2,6,2,9,3.825862366,14.63722284,4,492.2599528
27,29,56,1,2,7,1,2,3.825862366,14.63722284,2,486.9109616
28,28,56,2,2,0,0,8,3.825862366,14.63722284,0,483.9957416
29,27,56,2,1,1,7,0,3.825862366,14.63722284,2,467.9354792
24,33,57,1,2,4,5,6,3.848501131,14.81096096,9,493.8137886
25,32,57,1,2,5,4,4,3.848501131,14.81096096,7,497.9927322
26,31,57,1,2,6,3,6,3.848501131,14.81096096,5,499.9061253
27,30,57,1,2,7,2,4,3.848501131,14.81096096,3,498.2874165
28,29,57,2,2,0,1,6,3.848501131,14.81096096,1,494.2433748
29,28,57,2,2,1,0,3,3.848501131,14.81096096,1,484.6860822
24,34,58,1,2,4,6,9,3.870876641,14.98368597,10,501.3519246
25,33,58,1,2,5,5,2,3.870876641,14.98368597,8,504.4053404
26,32,58,1,2,6,4,9,3.870876641,14.98368597,6,509.9506972
27,31,58,1,2,7,3,2,3.870876641,14.98368597,4,506.8603702
28,30,58,2,2,0,2,9,3.870876641,14.98368597,2,506.4596018
29,29,58,2,2,1,1,1,3.870876641,14.98368597,0,497.1162368
30,28,58,2,2,2,0,7,3.870876641,14.98368597,2,486.9649086
24,35,59,1,2,4,7,6,3.892996416,15.15542109,11,505.5473705
25,34,59,1,2,5,6,4,3.892996416,15.15542109,9,512.1744216
26,33,59,1,2,6,5,6,3.892996416,15.15542109,7,516.5317014
27,32,59,1,2,7,4,4,3.892996416,15.15542109,5,517.3142361
28,31,59,2,2,0,3,6,3.892996416,15.15542109,3,515.4588808
29,30,59,2,2,1,2,4,3.892996416,15.15542109,1,509.8781593
30,29,59,2,2,2,1,5,3.892996416,15.15542109,1,499.9530318
24,36,60,1,2,4,8,9,3.914867641,15.32618865,12,512.411256
25,35,60,1,2,5,7,2,3.914867641,15.32618865,10,517.688352
26,34,60,1,2,6,6,9,3.914867641,15.32618865,8,525.351234
27,33,60,1,2,7,5,2,3.914867641,15.32618865,6,524.806152
28,32,60,2,2,0,4,9,3.914867641,15.32618865,4,526.846614
29,31,60,2,2,1,3,2,3.914867641,15.32618865,2,519.936282
30,30,60,2,2,2,2,8,3.914867641,15.32618865,0,514.983144
24,37,61,1,2,4,9,6,3.936497183,15.49601007,13,516.0705774
25,36,61,1,2,5,8,4,3.936497183,15.49601007,11,524.5338577
26,35,61,1,2,6,7,6,3.936497183,15.49601007,9,530.9298846
27,34,61,1,2,7,6,4,3.936497183,15.49601007,7,534.125211
28,33,61,2,2,0,5,6,3.936497183,15.49601007,5,534.6667141
29,32,61,2,2,1,4,4,3.936497183,15.49601007,3,531.6464028
30,31,61,2,2,2,3,6,3.936497183,15.49601007,1,525.2288978
31,30,61,2,2,3,2,3,3.936497183,15.49601007,1,515.2323093
24,38,62,1,2,4,10,9,3.95789161,15.66490599,14,522.4980002
25,37,62,1,2,5,9,2,3.95789161,15.66490599,12,529.3870124
26,36,62,1,2,6,8,9,3.95789161,15.66490599,10,538.9587522
27,35,62,1,2,7,7,2,3.95789161,15.66490599,8,540.7227514
28,34,62,2,2,0,6,9,3.95789161,15.66490599,6,545.262441
29,33,62,2,2,1,5,2,3.95789161,15.66490599,4,540.5212018
30,32,62,2,2,2,4,9,3.95789161,15.66490599,2,538.1193962
31,31,62,2,2,3,3,1,3.95789161,15.66490599,0,528.1559838
25,38,63,1,2,5,10,4,3.979057208,15.83289626,13,535.821426
26,37,63,1,2,6,9,6,3.979057208,15.83289626,11,543.7876437
27,36,63,1,2,7,8,4,3.979057208,15.83289626,9,549.2212236
28,35,63,2,2,0,7,6,3.979057208,15.83289626,7,552.1002165
29,34,63,2,2,1,6,4,3.979057208,15.83289626,5,551.3848452
30,33,63,2,2,2,5,6,3.979057208,15.83289626,3,547.2360558
31,32,63,2,2,3,4,4,3.979057208,15.83289626,1,540.7873821
32,31,63,2,2,4,3,5,3.979057208,15.83289626,1,530.3791521
25,39,64,1,2,5,11,2,4,16,14,539.99472
26,38,64,1,2,6,10,9,4,16,12,551.1928832
27,37,64,1,2,7,9,2,4,16,10,555.2334272
28,36,64,2,2,0,8,9,4,16,8,561.7576768
29,35,64,2,2,1,7,2,4,16,6,559.3007104
30,34,64,2,2,2,6,9,4,16,4,559.0979648
31,33,64,2,2,3,5,2,4,16,2,551.1444288
32,32,64,2,2,4,4,8,4,16,0,545.8447552
25,40,65,1,2,5,12,4,4.020725759,16.16623563,15,546.044343
26,39,65,1,2,6,11,6,4.020725759,16.16623563,13,555.512555
27,38,65,1,2,7,10,4,4.020725759,16.16623563,11,562.697512
28,37,65,2,2,0,9,6,4.020725759,16.16623563,9,567.855756
29,36,65,2,2,1,8,4,4.020725759,16.16623563,7,569.2112855
30,35,65,2,2,2,7,6,4.020725759,16.16623563,5,567.07729
31,34,65,2,2,3,6,4,4.020725759,16.16623563,3,563.0404065
32,33,65,2,2,4,5,6,4.020725759,16.16623563,1,556.078796
25,41,66,1,2,5,13,2,4.041240021,16.3316209,16,549.8987076
26,40,66,1,2,6,12,9,4.041240021,16.3316209,14,562.433817
27,39,66,1,2,7,11,2,4.041240021,16.3316209,12,567.9921654
28,38,66,2,2,0,10,9,4.041240021,16.3316209,10,576.8075676
29,37,66,2,2,1,9,2,4.041240021,16.3316209,8,576.277218
30,36,66,2,2,2,8,9,4.041240021,16.3316209,6,578.135811
31,35,66,2,2,3,7,2,4.041240021,16.3316209,4,572.1779646
32,34,66,2,2,4,6,9,4.041240021,16.3316209,2,569.2789278
33,33,66,2,2,5,5,1,4.041240021,16.3316209,0,558.9146244
26,41,67,1,2,6,13,6,4.0615481,16.49617297,15,566.1457053
27,40,67,1,2,7,12,4,4.0615481,16.49617297,13,574.9767274
28,39,67,2,2,0,11,6,4.0615481,16.49617297,11,582.6152835
29,38,67,2,2,1,10,4,4.0615481,16.49617297,9,585.4097999
30,37,67,2,2,2,9,6,4.0615481,16.49617297,7,585.1882778
31,36,67,2,2,3,8,4,4.0615481,16.49617297,5,583.404711
32,35,67,2,2,4,7,6,4.0615481,16.49617297,3,578.4169228
33,34,67,2,2,5,6,4,4.0615481,16.49617297,1,571.5480895
27,41,68,1,2,7,13,2,4.081655102,16.65990837,14,579.3688468
28,40,68,2,2,0,12,9,4.081655102,16.65990837,12,590.4077356
29,39,68,2,2,1,11,2,4.081655102,16.65990837,10,591.7286084
30,38,68,2,2,2,10,9,4.081655102,16.65990837,8,595.386376
31,37,68,2,2,3,9,2,4.081655102,16.65990837,6,591.682926
32,36,68,2,2,4,8,9,4.081655102,16.65990837,4,590.7933228
33,35,68,2,2,5,7,2,4.081655102,16.65990837,2,581.9267076
34,34,68,2,2,6,6,8,4.081655102,16.65990837,0,576.4392776
28,41,69,2,2,0,13,6,4.10156593,16.82284308,13,594.9938862
29,40,69,2,2,1,12,4,4.10156593,16.82284308,11,599.9691036
30,39,69,2,2,2,11,6,4.10156593,16.82284308,9,601.8684459
31,38,69,2,2,3,10,4,4.10156593,16.82284308,7,601.9960062
32,37,69,2,2,4,9,6,4.10156593,16.82284308,5,598.986516
33,36,69,2,2,5,8,4,4.10156593,16.82284308,3,594.2156766
34,35,69,2,2,6,7,6,4.10156593,16.82284308,1,586.7558658
35,34,69,2,2,7,6,3,4.10156593,16.82284308,1,575.7982794
27,43,70,1,2,7,15,2,4.1212853,16.98499252,16,590.39386
28,42,70,2,2,0,14,9,4.1212853,16.98499252,14,602.300419
29,41,70,2,2,1,13,2,4.1212853,16.98499252,12,605.280585
30,40,70,2,2,2,12,9,4.1212853,16.98499252,10,611.086602
31,39,70,2,2,3,11,2,4.1212853,16.98499252,8,609.649656
32,38,70,2,2,4,10,9,4.1212853,16.98499252,6,610.519196
33,37,70,2,2,5,9,2,4.1212853,16.98499252,4,603.508787
34,36,70,2,2,6,8,9,4.1212853,16.98499252,2,600.322366
35,35,70,2,2,7,7,1,4.1212853,16.98499252,0,589.035748
28,43,71,2,2,0,15,6,4.140817749,17.14637163,15,606.5641044
29,42,71,2,2,1,14,4,4.140817749,17.14637163,13,613.0866543
30,41,71,2,2,2,13,6,4.140817749,17.14637163,11,616.9219607
31,40,71,2,2,3,12,4,4.140817749,17.14637163,9,618.949955
32,39,71,2,2,4,11,6,4.140817749,17.14637163,7,617.9351378
33,38,71,2,2,5,10,4,4.140817749,17.14637163,5,615.139385
34,37,71,2,2,6,9,6,4.140817749,17.14637163,3,609.6103026
35,36,71,2,2,7,8,4,4.140817749,17.14637163,1,602.1838659
28,44,72,2,2,0,16,9,4.160167646,17.30699484,16,613.4552496
29,43,72,2,2,1,15,2,4.160167646,17.30699484,14,618.2298432
30,42,72,2,2,2,14,9,4.160167646,17.30699484,12,625.8099816
31,41,72,2,2,3,13,2,4.160167646,17.30699484,10,625.4704296
32,40,72,2,2,4,12,9,4.160167646,17.30699484,8,628.6857048
33,39,72,2,2,5,11,2,4.160167646,17.30699484,6,623.5472592
34,38,72,2,2,6,10,9,4.160167646,17.30699484,4,622.4032944
35,37,72,2,2,7,9,2,4.160167646,17.30699484,2,612.8145072
36,36,72,2,2,8,8,8,4.160167646,17.30699484,0,606.9109896
28,45,73,2,2,0,17,6,4.179339196,17.46687612,17,617.4086617
29,44,73,2,2,1,16,4,4.179339196,17.46687612,15,625.5056027
30,43,73,2,2,2,15,6,4.179339196,17.46687612,13,631.3292215
31,42,73,2,2,3,14,4,4.179339196,17.46687612,11,634.652802
32,41,73,2,2,4,13,6,4.179339196,17.46687612,9,635.46865
33,40,73,2,2,5,12,4,4.179339196,17.46687612,7,634.3415227
34,39,73,2,2,6,11,6,4.179339196,17.46687612,5,630.8338143
35,38,73,2,2,7,10,4,4.179339196,17.46687612,3,625.4698619
36,37,73,2,2,8,9,6,4.179339196,17.46687612,1,617.5934831
37,36,73,2,2,9,8,3,4.179339196,17.46687612,1,606.2709933
29,45,74,2,2,1,17,2,4.198336454,17.62602898,16,630.5956842
30,44,74,2,2,2,16,9,4.198336454,17.62602898,14,639.5638478
31,43,74,2,2,3,15,2,4.198336454,17.62602898,12,641.0744024
32,42,74,2,2,4,14,9,4.198336454,17.62602898,10,645.6648814
33,41,74,2,2,5,13,2,4.198336454,17.62602898,8,642.320148
34,40,74,2,2,6,12,9,4.198336454,17.62602898,6,642.890947
35,39,74,2,2,7,11,2,4.198336454,17.62602898,4,635.183551
36,38,74,2,2,8,10,9,4.198336454,17.62602898,2,631.444886
37,37,74,2,2,9,9,1,4.198336454,17.62602898,0,620.2467102
29,46,75,2,2,1,18,4,4.217163327,17.78446652,17,637.1310075
30,45,75,2,2,2,17,6,4.217163327,17.78446652,15,644.4373575
31,44,75,2,2,3,16,4,4.217163327,17.78446652,13,649.5567375
32,43,75,2,2,4,15,6,4.217163327,17.78446652,11,652.17072
33,42,75,2,2,5,14,4,4.217163327,17.78446652,9,652.56561
34,41,75,2,2,6,13,6,4.217163327,17.78446652,7,650.9185425
35,40,75,2,2,7,12,4,4.217163327,17.78446652,5,647.0737275
36,39,75,2,2,8,11,6,4.217163327,17.78446652,3,641.5079925
37,38,75,2,2,9,10,4,4.217163327,17.78446652,1,633.620715
29,47,76,2,2,1,19,2,4.235823584,17.94220144,18,641.7137368
30,46,76,2,2,2,18,9,4.235823584,17.94220144,16,652.252786
31,45,76,2,2,3,17,2,4.235823584,17.94220144,14,655.4640672
32,44,76,2,2,4,16,9,4.235823584,17.94220144,12,661.5979664
33,43,76,2,2,5,15,2,4.235823584,17.94220144,10,659.8941072
34,42,76,2,2,6,14,9,4.235823584,17.94220144,8,662.0723356
35,41,76,2,2,7,13,2,4.235823584,17.94220144,6,656.327108
36,40,76,2,2,8,12,9,4.235823584,17.94220144,4,654.2693852
37,39,76,2,2,9,11,2,4.235823584,17.94220144,2,644.9524236
38,38,76,2,2,10,10,8,4.235823584,17.94220144,0,637.9386344
29,48,77,2,2,1,20,4,4.254320865,18.09924602,19,647.6662577
30,47,77,2,2,2,19,6,4.254320865,18.09924602,17,656.8102849
31,46,77,2,2,3,18,4,4.254320865,18.09924602,15,663.2310839
32,45,77,2,2,4,17,6,4.254320865,18.09924602,13,667.6692561
33,44,77,2,2,5,16,4,4.254320865,18.09924602,11,669.5903753
34,43,77,2,2,6,15,6,4.254320865,18.09924602,9,669.4911916
35,42,77,2,2,7,14,4,4.254320865,18.09924602,7,667.3441621
36,41,77,2,2,8,13,6,4.254320865,18.09924602,5,663.496449
37,40,77,2,2,9,12,4,4.254320865,18.09924602,3,657.3751492
38,39,77,2,2,10,11,6,4.254320865,18.09924602,1,649.5657476
29,49,78,2,2,1,21,2,4.272658682,18.25561221,20,651.664221
30,48,78,2,2,2,20,9,4.272658682,18.25561221,18,663.57564
31,47,78,2,2,3,19,2,4.272658682,18.25561221,16,669.0141354
32,46,78,2,2,4,18,9,4.272658682,18.25561221,14,676.3897608
33,45,78,2,2,5,17,2,4.272658682,18.25561221,12,676.562328
34,44,78,2,2,6,16,9,4.272658682,18.25561221,10,679.9889616
35,43,78,2,2,7,15,2,4.272658682,18.25561221,8,675.6328332
36,42,78,2,2,8,14,9,4.272658682,18.25561221,6,675.576603
37,41,78,2,2,9,13,2,4.272658682,18.25561221,4,667.5513936
38,40,78,2,2,10,12,9,4.272658682,18.25561221,2,663.0075738
30,49,79,2,2,2,21,6,4.290840427,18.41131157,19,667.5960175
31,48,79,2,2,3,20,4,4.290840427,18.41131157,17,675.9297275
32,47,79,2,2,4,19,6,4.290840427,18.41131157,15,682.1262031
33,46,79,2,2,5,18,4,4.290840427,18.41131157,13,685.4527588
34,45,79,2,2,6,17,6,4.290840427,18.41131157,11,686.9517917
35,44,79,2,2,7,16,4,4.290840427,18.41131157,9,686.3200524
36,43,79,2,2,8,15,6,4.290840427,18.41131157,7,683.911927
37,42,79,2,2,9,14,4,4.290840427,18.41131157,5,679.4900679
38,41,79,2,2,10,13,6,4.290840427,18.41131157,3,673.3846082
30,50,80,2,3,2,0,9,4.30886938,18.56635533,20,673.883656
31,49,80,2,2,3,21,2,4.30886938,18.56635533,18,680.67636
32,48,80,2,2,4,20,9,4.30886938,18.56635533,16,690.205656
33,47,80,2,2,5,19,2,4.30886938,18.56635533,14,692.102592
34,46,80,2,2,6,18,9,4.30886938,18.56635533,12,696.865136
35,45,80,2,2,7,17,2,4.30886938,18.56635533,10,694.212328
36,44,80,2,2,8,16,9,4.30886938,18.56635533,8,695.434408
37,43,80,2,2,9,15,2,4.30886938,18.56635533,6,688.93408
38,42,80,2,2,10,14,9,4.30886938,18.56635533,4,686.287728
39,41,80,2,2,11,13,2,4.30886938,18.56635533,2,676.342072
30,51,81,2,3,2,1,6,4.326748711,18.72075441,21,676.5060222
31,50,81,2,3,3,0,4,4.326748711,18.72075441,19,687.1519656
32,49,81,2,2,4,21,6,4.326748711,18.72075441,17,695.0333547
33,48,81,2,2,5,20,4,4.326748711,18.72075441,15,700.4926251
34,47,81,2,2,6,19,6,4.326748711,18.72075441,13,703.5659838
35,46,81,2,2,7,18,4,4.326748711,18.72075441,11,704.3716665
36,45,81,2,2,8,17,6,4.326748711,18.72075441,9,703.3084686
37,44,81,2,2,9,16,4,4.326748711,18.72075441,7,700.2866259
38,43,81,2,2,10,15,6,4.326748711,18.72075441,5,695.5757145
39,42,81,2,2,11,14,4,4.326748711,18.72075441,3,688.9781511
30,52,82,2,3,2,2,9,4.344481486,18.87451938,22,680.691635
31,51,82,2,3,3,1,2,4.344481486,18.87451938,20,690.5260508
32,50,82,2,3,4,0,9,4.344481486,18.87451938,18,702.2280494
33,49,82,2,2,5,21,2,4.344481486,18.87451938,16,706.1360546
34,48,82,2,2,6,20,9,4.344481486,18.87451938,14,712.8421786
35,47,82,2,2,7,19,2,4.344481486,18.87451938,12,711.9646146
36,46,82,2,2,8,18,9,4.344481486,18.87451938,10,714.2753828
37,45,82,2,2,9,17,2,4.344481486,18.87451938,8,709.089055
38,44,82,2,2,10,16,9,4.344481486,18.87451938,6,708.128958
39,43,82,2,2,11,15,2,4.344481486,18.87451938,4,699.4006484
40,42,82,2,2,12,14,9,4.344481486,18.87451938,2,694.1682612
31,52,83,2,3,3,2,4,4.362070671,19.02766054,21,694.9237748
32,51,83,2,3,4,1,6,4.362070671,19.02766054,19,705.8607346
33,50,83,2,3,5,0,4,4.362070671,19.02766054,17,713.771282
34,49,83,2,2,6,21,6,4.362070671,19.02766054,15,718.660148
35,48,83,2,2,7,20,4,4.362070671,19.02766054,13,721.5509716
36,47,83,2,2,8,19,6,4.362070671,19.02766054,11,721.7455485
37,46,83,2,2,9,18,4,4.362070671,19.02766054,9,720.0432019
38,45,83,2,2,10,17,6,4.362070671,19.02766054,7,716.9878308
39,44,83,2,2,11,16,4,4.362070671,19.02766054,5,711.6135393
40,43,83,2,2,12,15,6,4.362070671,19.02766054,3,704.5371751
31,53,84,2,3,3,3,2,4.37951914,19.1801879,22,697.8321
32,52,84,2,3,4,2,9,4.37951914,19.1801879,20,711.1040496
33,51,84,2,3,5,1,2,4.37951914,19.1801879,18,718.026834
34,50,84,2,3,6,0,9,4.37951914,19.1801879,16,727.338654
35,49,84,2,2,7,21,2,4.37951914,19.1801879,14,728.3916696
36,48,84,2,2,8,20,9,4.37951914,19.1801879,12,732.2655732
37,47,84,2,2,9,19,2,4.37951914,19.1801879,10,728.8028496
38,46,84,2,2,10,18,9,4.37951914,19.1801879,8,728.9111088
39,45,84,2,2,11,17,2,4.37951914,19.1801879,6,721.3736208
40,44,84,2,2,12,16,9,4.37951914,19.1801879,4,718.1185284
41,43,84,2,2,13,15,2,4.37951914,19.1801879,2,707.1083292
31,54,85,2,3,3,4,4,4.396829672,19.33211117,23,701.5533395
32,53,85,2,3,4,3,6,4.396829672,19.33211117,21,714.1503565
33,52,85,2,3,5,2,4,4.396829672,19.33211117,19,723.4337335
34,51,85,2,3,6,1,6,4.396829672,19.33211117,17,731.8758825
35,50,85,2,3,7,0,4,4.396829672,19.33211117,15,737.255371
36,49,85,2,2,8,21,6,4.396829672,19.33211117,13,739.3778805
37,48,85,2,2,9,20,4,4.396829672,19.33211117,11,739.282536
38,47,85,2,2,10,19,6,4.396829672,19.33211117,9,737.4361405
39,46,85,2,2,11,18,4,4.396829672,19.33211117,7,733.392631
40,45,85,2,2,12,17,6,4.396829672,19.33211117,5,727.943349
41,44,85,2,2,13,16,4,4.396829672,19.33211117,3,720.2654945
42,43,85,2,2,14,15,6,4.396829672,19.33211117,1,710.71322
33,53,86,2,3,5,3,2,4.414004962,19.48343981,20,727.278049
34,52,86,2,3,6,2,9,4.414004962,19.48343981,18,738.0367264
35,51,86,2,3,7,1,2,4.414004962,19.48343981,16,742.3834674
36,50,86,2,3,8,0,9,4.414004962,19.48343981,14,749.234537
37,49,86,2,2,9,21,2,4.414004962,19.48343981,12,747.9335204
38,48,86,2,2,10,20,9,4.414004962,19.48343981,10,748.9272676
39,47,86,2,2,11,19,2,4.414004962,19.48343981,8,742.9049198
40,46,86,2,2,12,18,9,4.414004962,19.48343981,6,740.8084978
41,45,86,2,2,13,17,2,4.414004962,19.48343981,4,731.1911866
42,44,86,2,2,14,16,9,4.414004962,19.48343981,2,725.385705
33,54,87,2,3,5,4,4,4.431047622,19.63418303,21,732.0051327
34,53,87,2,3,6,3,6,4.431047622,19.63418303,19,742.031004
35,52,87,2,3,7,2,4,4.431047622,19.63418303,17,748.7142135
36,51,87,2,3,8,1,6,4.431047622,19.63418303,15,754.749708
37,50,87,2,3,9,0,4,4.431047622,19.63418303,13,757.8556341
38,49,87,2,2,10,21,6,4.431047622,19.63418303,11,757.3555581
39,48,87,2,2,11,20,4,4.431047622,19.63418303,9,754.7115237
40,47,87,2,2,12,19,6,4.431047622,19.63418303,7,750.2579415
41,46,87,2,2,13,18,4,4.431047622,19.63418303,5,744.0029373
42,45,87,2,2,14,17,6,4.431047622,19.63418303,3,736.2309141
43,44,87,2,2,15,16,4,4.431047622,19.63418303,1,726.2538063
34,54,88,2,3,6,4,9,4.447960181,19.78434977,20,747.560396
35,53,88,2,3,7,3,2,4.447960181,19.78434977,18,753.6098152
36,52,88,2,3,8,2,9,4.447960181,19.78434977,16,761.8027912
37,51,88,2,3,9,1,2,4.447960181,19.78434977,14,763.9381552
38,50,88,2,3,10,0,9,4.447960181,19.78434977,12,768.4684304
39,49,88,2,2,11,21,2,4.447960181,19.78434977,10,764.0634848
40,48,88,2,2,12,20,9,4.447960181,19.78434977,8,762.6109832
41,47,88,2,2,13,19,2,4.447960181,19.78434977,6,754.3713144
42,46,88,2,2,14,18,9,4.447960181,19.78434977,4,750.1039656
43,45,88,2,2,15,17,2,4.447960181,19.78434977,2,738.3053744
34,55,89,2,3,6,5,6,4.464745096,19.93394877,21,750.7399111
35,54,89,2,3,7,4,4,4.464745096,19.93394877,19,759.2394378
36,53,89,2,3,8,3,6,4.464745096,19.93394877,17,766.7186062
37,52,89,2,3,9,2,4,4.464745096,19.93394877,15,771.1128655
38,51,89,2,3,10,1,6,4.464745096,19.93394877,13,774.827147
39,50,89,2,3,11,0,4,4.464745096,19.93394877,11,775.546979
40,49,89,2,2,12,21,6,4.464745096,19.93394877,9,771.9313985
41,48,89,2,2,13,20,4,4.464745096,19.93394877,7,766.8968376
42,47,89,2,2,14,19,6,4.464745096,19.93394877,5,760.5036739
43,46,89,2,2,15,18,4,4.464745096,19.93394877,3,752.1012462
44,45,89,2,2,16,17,6,4.464745096,19.93394877,1,742.293464
35,55,90,2,3,7,5,2,4.481404747,20.0829885,20,763.036785
36,54,90,2,3,8,4,9,4.481404747,20.0829885,18,773.213391
37,53,90,2,3,9,3,2,4.481404747,20.0829885,16,776.837358
38,52,90,2,3,10,2,9,4.481404747,20.0829885,14,782.640387
39,51,90,2,3,11,1,2,4.481404747,20.0829885,12,782.404002
40,50,90,2,3,12,0,9,4.481404747,20.0829885,10,783.897291
41,49,90,2,2,13,21,2,4.481404747,20.0829885,8,777.00393
42,48,90,2,2,14,20,9,4.481404747,20.0829885,6,773.732565
43,47,90,2,2,15,19,2,4.481404747,20.0829885,4,763.5024
44,46,90,2,2,16,18,9,4.481404747,20.0829885,2,756.879156
35,56,91,2,3,7,6,4,4.497941445,20.23147725,21,768.2151022
36,55,91,2,3,8,5,6,4.497941445,20.23147725,19,777.2994229
37,54,91,2,3,9,4,4,4.497941445,20.23147725,17,783.2881511
38,53,91,2,3,10,3,6,4.497941445,20.23147725,15,788.4127069
39,52,91,2,3,11,2,4,4.497941445,20.23147725,13,790.3297311
40,51,91,2,3,12,1,6,4.497941445,20.23147725,11,791.0916559
41,50,91,2,3,13,0,4,4.497941445,20.23147725,9,789.0517453
42,49,91,2,2,14,21,6,4.497941445,20.23147725,7,783.8402026
43,48,91,2,2,15,20,4,4.497941445,20.23147725,5,776.8356778
44,47,91,2,2,16,19,6,4.497941445,20.23147725,3,768.3065117
35,57,92,2,3,7,7,2,4.514357435,20.37942306,22,771.4119316
36,56,92,2,3,8,6,9,4.514357435,20.37942306,20,783.1661
37,55,92,2,3,9,5,2,4.514357435,20.37942306,18,788.38687
38,54,92,2,3,10,4,9,4.514357435,20.37942306,16,795.699444
39,53,92,2,3,11,3,2,4.514357435,20.37942306,14,796.8662248
40,52,92,2,3,12,2,9,4.514357435,20.37942306,12,799.7264036
41,51,92,2,3,13,1,2,4.514357435,20.37942306,10,796.9383252
42,50,92,2,3,14,0,9,4.514357435,20.37942306,8,796.5112704
43,49,92,2,2,15,21,2,4.514357435,20.37942306,6,787.846048
44,48,92,2,2,16,20,9,4.514357435,20.37942306,4,782.439208
45,47,92,2,2,17,19,2,4.514357435,20.37942306,2,770.3547412
36,57,93,2,3,8,7,6,4.530654896,20.52683379,21,786.6040905
37,56,93,2,3,9,6,4,4.530654896,20.52683379,19,794.3056437
38,55,93,2,3,10,5,6,4.530654896,20.52683379,17,800.9892375
39,54,93,2,3,11,4,4,4.530654896,20.52683379,15,804.3482022
40,53,93,2,3,12,3,6,4.530654896,20.52683379,13,806.4607251
41,52,93,2,3,13,2,4,4.530654896,20.52683379,11,805.7691957
42,51,93,2,3,14,1,6,4.530654896,20.52683379,9,804.5810835
43,50,93,2,3,15,0,4,4.530654896,20.52683379,7,800.5977726
44,49,93,2,2,16,21,6,4.530654896,20.52683379,5,793.4260311
45,48,93,2,2,17,20,4,4.530654896,20.52683379,3,784.4387715
36,58,94,2,3,8,8,9,4.546835944,20.6737171,22,791.8871892
37,57,94,2,3,9,7,2,4.546835944,20.6737171,20,798.3198536
38,56,94,2,3,10,6,9,4.546835944,20.6737171,18,807.8204336
39,55,94,2,3,11,5,2,4.546835944,20.6737171,16,810.5438392
40,54,94,2,3,12,4,9,4.546835944,20.6737171,14,814.6793504
41,53,94,2,3,13,3,2,4.546835944,20.6737171,12,812.9967316
42,52,94,2,3,14,2,9,4.546835944,20.6737171,10,814.2594054
43,51,94,2,3,15,1,2,4.546835944,20.6737171,8,809.2213062
44,50,94,2,3,16,0,9,4.546835944,20.6737171,6,806.864228
45,49,94,2,2,17,21,2,4.546835944,20.6737171,4,796.4059102
46,48,94,2,2,18,20,9,4.546835944,20.6737171,2,788.8182208
36,59,95,2,3,8,9,6,4.562902635,20.82008046,23,794.7696485
37,58,95,2,3,9,8,4,4.562902635,20.82008046,21,803.7186865
38,57,95,2,3,10,7,6,4.562902635,20.82008046,19,812.1633125
39,56,95,2,3,11,6,4,4.562902635,20.82008046,17,817.471618
40,55,95,2,3,12,5,6,4.562902635,20.82008046,15,821.141278
41,54,95,2,3,13,4,4,4.562902635,20.82008046,13,821.4852635
42,53,95,2,3,14,3,6,4.562902635,20.82008046,11,821.628514
43,52,95,2,3,15,2,4,4.562902635,20.82008046,9,819.1556545
44,51,95,2,3,16,1,6,4.562902635,20.82008046,7,815.809707
45,50,95,2,3,17,0,4,4.562902635,20.82008046,5,809.9102165
46,49,95,2,2,18,21,6,4.562902635,20.82008046,3,800.7531665
36,60,96,2,3,8,10,9,4.57885697,20.96593115,24,799.7637216
37,59,96,2,3,9,9,2,4.57885697,20.96593115,22,807.2540448
38,58,96,2,3,10,8,9,4.57885697,20.96593115,20,818.0355936
39,57,96,2,3,11,7,2,4.57885697,20.96593115,18,822.6649824
40,56,96,2,3,12,6,9,4.57885697,20.96593115,16,828.9915168
41,55,96,2,3,13,5,2,4.57885697,20.96593115,14,828.3731328
42,54,96,2,3,14,4,9,4.57885697,20.96593115,12,830.782848
43,53,96,2,3,15,3,2,4.57885697,20.96593115,10,827.0272608
44,52,96,2,3,16,2,9,4.57885697,20.96593115,8,826.503648
45,51,96,2,3,17,1,2,4.57885697,20.96593115,6,819.328656
46,50,96,2,3,18,0,9,4.57885697,20.96593115,4,815.0419872
47,49,96,2,2,19,21,2,4.57885697,20.96593115,2,802.5878688
37,60,97,2,3,9,10,4,4.594700892,21.11127629,23,812.4901584
38,59,97,2,3,10,9,6,4.594700892,21.11127629,21,821.7693433
39,58,97,2,3,11,8,4,4.594700892,21.11127629,19,828.5217752
40,57,97,2,3,12,7,6,4.594700892,21.11127629,17,834.5606654
41,56,97,2,3,13,6,4,4.594700892,21.11127629,15,836.4444248
42,55,97,2,3,14,5,6,4.594700892,21.11127629,13,837.6039822
43,54,97,2,3,15,4,4,4.594700892,21.11127629,11,836.5013638
44,53,97,2,3,16,3,6,4.594700892,21.11127629,9,834.6151503
45,52,97,2,3,17,2,4,4.594700892,21.11127629,7,830.3098053
46,51,97,2,3,18,1,6,4.594700892,21.11127629,5,824.7357391
47,50,97,2,3,19,0,4,4.594700892,21.11127629,3,817.0515737
37,61,98,2,3,9,11,2,4.610436292,21.2561228,24,816.4114812
38,60,98,2,3,10,10,9,4.610436292,21.2561228,22,827.682373
39,59,98,2,3,11,9,2,4.610436292,21.2561228,20,832.7663876
40,58,98,2,3,12,8,9,4.610436292,21.2561228,18,840.9770432
41,57,98,2,3,13,7,2,4.610436292,21.2561228,16,842.4375568
42,56,98,2,3,14,6,9,4.610436292,21.2561228,14,846.2465718
43,55,98,2,3,15,5,2,4.610436292,21.2561228,12,843.7804606
44,54,98,2,3,16,4,9,4.610436292,21.2561228,10,844.790772
45,53,98,2,3,17,3,2,4.610436292,21.2561228,8,838.9587724
46,52,98,2,3,18,2,9,4.610436292,21.2561228,6,836.3221902
47,51,98,2,3,19,1,2,4.610436292,21.2561228,4,827.2852868
48,50,98,2,3,20,0,9,4.610436292,21.2561228,2,821.0729394
37,62,99,2,3,9,12,4,4.626065009,21.40047747,25,821.234799
38,61,99,2,3,10,11,6,4.626065009,21.40047747,23,831.8498265
39,60,99,2,3,11,10,4,4.626065009,21.40047747,21,839.1926862
40,59,99,2,3,12,9,6,4.626065009,21.40047747,19,845.383275
41,58,99,2,3,13,8,4,4.626065009,21.40047747,17,849.3196041
42,57,99,2,3,14,7,6,4.626065009,21.40047747,15,852.1720218
43,56,99,2,3,15,6,4,4.626065009,21.40047747,13,852.7474395
44,55,99,2,3,16,5,6,4.626065009,21.40047747,11,852.2626068
45,54,99,2,3,17,4,4,4.626065009,21.40047747,9,849.4393941
46,53,99,2,3,18,3,6,4.626065009,21.40047747,7,845.2553868
47,52,99,2,3,19,2,4,4.626065009,21.40047747,5,839.0026656
48,51,99,2,3,20,1,6,4.626065009,21.40047747,3,831.4389666
37,63,100,2,3,9,13,2,4.641588834,21.5443469,26,824.45085
38,62,100,2,3,10,12,9,4.641588834,21.5443469,24,837.22012
39,61,100,2,3,11,11,2,4.641588834,21.5443469,22,843.94151
40,60,100,2,3,12,10,9,4.641588834,21.5443469,20,852.21066
41,59,100,2,3,13,9,2,4.641588834,21.5443469,18,854.84683
42,58,100,2,3,14,8,9,4.641588834,21.5443469,16,860.46626
43,57,100,2,3,15,7,2,4.641588834,21.5443469,14,859.51184
44,56,100,2,3,16,6,9,4.641588834,21.5443469,12,861.93593
45,55,100,2,3,17,5,2,4.641588834,21.5443469,10,857.51732
46,54,100,2,3,18,4,9,4.641588834,21.5443469,8,856.35652
47,53,100,2,3,19,3,2,4.641588834,21.5443469,6,848.49947
48,52,100,2,3,20,2,9,4.641588834,21.5443469,4,843.77375
49,51,100,2,3,21,1,2,4.641588834,21.5443469,2,832.97495
37,64,101,2,3,9,14,4,4.657009508,21.68773756,27,828.8237053
38,63,101,2,3,10,13,6,4.657009508,21.68773756,25,840.7988511
39,62,101,2,3,11,12,4,4.657009508,21.68773756,23,849.7463805
40,61,101,2,3,12,11,6,4.657009508,21.68773756,21,857.0702339
41,60,101,2,3,13,10,4,4.657009508,21.68773756,19,862.0183855
42,59,101,2,3,14,9,6,4.657009508,21.68773756,17,865.8645059
43,58,101,2,3,15,8,4,4.657009508,21.68773756,15,867.9067966
44,57,101,2,3,16,7,6,4.657009508,21.68773756,13,868.737966
45,56,101,2,3,17,6,4,4.657009508,21.68773756,11,867.4099372
46,55,101,2,3,18,5,6,4.657009508,21.68773756,9,864.6473044
47,54,101,2,3,19,4,4,4.657009508,21.68773756,7,859.7671965
48,53,101,2,3,20,3,6,4.657009508,21.68773756,5,853.4869357
49,52,101,2,3,21,2,4,4.657009508,21.68773756,3,845.413026
37,65,102,2,3,9,15,2,4.672328728,21.83065575,28,831.5799186
38,64,102,2,3,10,14,9,4.672328728,21.83065575,26,845.7045726
39,63,102,2,3,11,13,2,4.672328728,21.83065575,24,853.9355544
40,62,102,2,3,12,12,9,4.672328728,21.83065575,22,863.561988
41,61,102,2,3,13,11,2,4.672328728,21.83065575,20,867.496485
42,60,102,2,3,14,10,9,4.672328728,21.83065575,18,873.9767388
43,59,102,2,3,15,9,2,4.672328728,21.83065575,16,874.2064428
44,58,102,2,3,16,8,9,4.672328728,21.83065575,14,877.957605
45,57,102,2,3,17,7,2,4.672328728,21.83065575,12,874.8521436
46,56,102,2,3,18,6,9,4.672328728,21.83065575,10,875.1894474
47,55,102,2,3,19,5,2,4.672328728,21.83065575,8,868.75083
48,54,102,2,3,20,4,9,4.672328728,21.83065575,6,865.3814844
49,53,102,2,3,21,3,2,4.672328728,21.83065575,4,855.6343338
50,52,102,3,3,0,2,9,4.672328728,21.83065575,2,849.0919926
39,64,103,2,3,11,14,4,4.687548148,21.97310764,25,859.2912608
40,63,103,2,3,12,13,6,4.687548148,21.97310764,23,867.8608711
41,62,103,2,3,13,12,4,4.687548148,21.97310764,21,874.298196
42,61,103,2,3,14,11,6,4.687548148,21.97310764,19,879.4415216
43,60,103,2,3,15,10,4,4.687548148,21.97310764,17,882.3087635
44,59,103,2,3,16,9,6,4.687548148,21.97310764,15,884.1896568
45,58,103,2,3,17,8,4,4.687548148,21.97310764,13,884.1718481
46,57,103,2,3,18,7,6,4.687548148,21.97310764,11,882.8147819
47,56,103,2,3,19,6,4,4.687548148,21.97310764,9,879.378156
48,55,103,2,3,20,5,6,4.687548148,21.97310764,7,874.4447341
49,54,103,2,3,21,4,4,4.687548148,21.97310764,5,867.6431497
40,64,104,2,3,12,14,9,4.702669375,22.11509925,24,873.8408536
41,63,104,2,3,13,13,2,4.702669375,22.11509925,22,879.1518528
42,62,104,2,3,14,12,9,4.702669375,22.11509925,20,886.9022552
43,61,104,2,3,15,11,2,4.702669375,22.11509925,18,888.275128
44,60,104,2,3,16,10,9,4.702669375,22.11509925,16,893.0895792
45,59,104,2,3,17,9,2,4.702669375,22.11509925,14,891.1708104
46,58,104,2,3,18,8,9,4.702669375,22.11509925,12,892.824244
47,57,104,2,3,19,7,2,4.702669375,22.11509925,10,887.76324
48,56,104,2,3,20,6,9,4.702669375,22.11509925,8,885.8328128
49,55,104,2,3,21,5,2,4.702669375,22.11509925,6,877.264752
50,54,104,3,3,0,4,9,4.702669375,22.11509925,4,871.9267856
40,65,105,2,3,12,15,6,4.71769398,22.25663649,25,877.65279
41,64,105,2,3,13,14,4,4.71769398,22.25663649,23,885.3277125
42,63,105,2,3,14,13,6,4.71769398,22.25663649,21,891.960615
43,62,105,2,3,15,12,4,4.71769398,22.25663649,19,896.133777
44,61,105,2,3,16,11,6,4.71769398,22.25663649,17,898.999668
45,60,105,2,3,17,10,4,4.71769398,22.25663649,15,900.1340565
46,59,105,2,3,18,9,6,4.71769398,22.25663649,13,899.9183445
47,58,105,2,3,19,8,4,4.71769398,22.25663649,11,897.788934
48,57,105,2,3,20,7,6,4.71769398,22.25663649,9,894.269586
49,56,105,2,3,21,6,4,4.71769398,22.25663649,7,888.7939725
50,55,105,3,3,0,5,6,4.71769398,22.25663649,5,881.709045
51,54,105,3,3,1,4,4,4.71769398,22.25663649,3,871.6041915
41,65,106,2,3,13,15,2,4.732623491,22.39772511,24,889.6861642
42,64,106,2,3,14,14,9,4.732623491,22.39772511,22,898.8291412
43,63,106,2,3,15,13,2,4.732623491,22.39772511,20,901.695042
44,62,106,2,3,16,12,9,4.732623491,22.39772511,18,907.4597036
45,61,106,2,3,17,11,2,4.732623491,22.39772511,16,906.7167602
46,60,106,2,3,18,10,9,4.732623491,22.39772511,14,909.4793004
47,59,106,2,3,19,9,2,4.732623491,22.39772511,12,905.7318082
48,58,106,2,3,20,8,9,4.732623491,22.39772511,10,905.1392152
49,57,106,2,3,21,7,2,4.732623491,22.39772511,8,897.8328578
50,56,106,3,3,0,6,9,4.732623491,22.39772511,6,893.7960598
51,55,106,3,3,1,5,2,4.732623491,22.39772511,4,882.1333144
52,54,106,3,3,2,4,9,4.732623491,22.39772511,2,873.0974292
41,66,107,2,3,13,16,4,4.747459399,22.53837074,25,895.2786086
42,65,107,2,3,14,15,6,4.747459399,22.53837074,23,903.317433
43,64,107,2,3,15,14,4,4.747459399,22.53837074,21,908.7400753
44,63,107,2,3,16,13,6,4.747459399,22.53837074,19,913.0703332
45,62,107,2,3,17,12,4,4.747459399,22.53837074,17,915.289128
46,61,107,2,3,18,11,6,4.747459399,22.53837074,15,916.0157222
47,60,107,2,3,19,10,4,4.747459399,22.53837074,13,915.2674284
48,59,107,2,3,20,9,6,4.747459399,22.53837074,11,913.0687068
49,58,107,2,3,21,8,4,4.747459399,22.53837074,9,908.8626973
50,57,107,3,3,0,7,6,4.747459399,22.53837074,7,903.0259222
51,56,107,3,3,1,6,4,4.747459399,22.53837074,5,894.3845808
41,67,108,2,3,13,17,2,4.762203156,22.6785789,26,899.1713232
42,66,108,2,3,14,16,9,4.762203156,22.6785789,24,909.5930748
43,65,108,2,3,15,15,2,4.762203156,22.6785789,22,913.9842576
44,64,108,2,3,16,14,9,4.762203156,22.6785789,20,920.9404836
45,63,108,2,3,17,13,2,4.762203156,22.6785789,18,921.5278956
46,62,108,2,3,18,12,9,4.762203156,22.6785789,16,925.2386028
47,61,108,2,3,19,11,2,4.762203156,22.6785789,14,922.5388296
48,60,108,2,3,20,10,9,4.762203156,22.6785789,12,923.4021168
49,59,108,2,3,21,9,2,4.762203156,22.6785789,10,917.4871728
50,58,108,3,3,0,8,9,4.762203156,22.6785789,8,914.6549484
51,57,108,3,3,1,7,2,4.762203156,22.6785789,6,904.2479928
52,56,108,3,3,2,6,9,4.762203156,22.6785789,4,896.8019868
42,67,109,2,3,14,17,6,4.776856181,22.81835497,25,913.5743767
43,66,109,2,3,15,16,4,4.776856181,22.81835497,23,920.4155764
44,65,109,2,3,16,15,6,4.776856181,22.81835497,21,926.088852
45,64,109,2,3,17,14,4,4.776856181,22.81835497,19,929.5673036
46,63,109,2,3,18,13,6,4.776856181,22.81835497,17,931.3921925
47,62,109,2,3,19,12,4,4.776856181,22.81835497,15,931.7227895
48,61,109,2,3,20,11,6,4.776856181,22.81835497,13,930.7253414
49,60,109,2,3,21,10,4,4.776856181,22.81835497,11,927.9281943
50,59,109,3,3,0,9,6,4.776856181,22.81835497,9,923.2864947
51,58,109,3,3,1,8,4,4.776856181,22.81835497,7,916.1249549
52,57,109,3,3,2,7,6,4.776856181,22.81835497,5,906.8070245
53,56,109,3,3,3,6,4,4.776856181,22.81835497,3,895.9817876
42,68,110,2,3,14,18,9,4.791419857,22.95770425,26,919.52223
43,67,110,2,3,15,17,2,4.791419857,22.95770425,24,925.238633
44,66,110,2,3,16,16,9,4.791419857,22.95770425,22,933.494353
45,65,110,2,3,17,15,2,4.791419857,22.95770425,20,935.468061
46,64,110,2,3,18,14,9,4.791419857,22.95770425,18,940.18793
47,63,110,2,3,19,13,2,4.791419857,22.95770425,16,938.531979
48,62,110,2,3,20,12,9,4.791419857,22.95770425,14,940.640305
49,61,110,2,3,21,11,2,4.791419857,22.95770425,12,935.979957
50,60,110,3,3,0,10,9,4.791419857,22.95770425,10,934.569625
51,59,110,3,3,1,9,2,4.791419857,22.95770425,8,925.395031
52,58,110,3,3,2,8,9,4.791419857,22.95770425,6,919.39276
53,57,110,3,3,3,7,2,4.791419857,22.95770425,4,906.848437
54,56,110,3,3,4,6,9,4.791419857,22.95770425,2,897.520888
42,69,111,2,3,14,19,6,4.805895534,23.09663188,27,922.9975452
43,68,111,2,3,15,18,4,4.805895534,23.09663188,25,931.3000566
44,67,111,2,3,16,17,6,4.805895534,23.09663188,23,938.2783602
45,66,111,2,3,17,16,4,4.805895534,23.09663188,21,943.0145637
46,65,111,2,3,18,15,6,4.805895534,23.09663188,19,945.9142278
47,64,111,2,3,19,14,4,4.805895534,23.09663188,17,947.3614458
48,63,111,2,3,20,13,6,4.805895534,23.09663188,15,947.6158911
49,62,111,2,3,21,12,4,4.805895534,23.09663188,13,945.9733464
50,61,111,3,3,0,11,6,4.805895534,23.09663188,11,942.737541
51,60,111,3,3,1,10,4,4.805895534,23.09663188,9,936.8533533
52,59,111,3,3,2,9,6,4.805895534,23.09663188,7,928.8217485
53,58,111,3,3,3,8,4,4.805895534,23.09663188,5,919.4057073
43,69,112,2,3,15,19,2,4.820284528,23.23514293,26,935.6056304
44,68,112,2,3,16,18,9,4.820284528,23.23514293,24,945.1952272
45,67,112,2,3,17,17,2,4.820284528,23.23514293,22,948.5130592
46,66,112,2,3,18,16,9,4.820284528,23.23514293,20,954.320696
47,65,112,2,3,19,15,2,4.820284528,23.23514293,18,953.8010384
48,64,112,2,3,20,14,9,4.820284528,23.23514293,16,957.0098272
49,63,112,2,3,21,13,2,4.820284528,23.23514293,14,953.6427488
50,62,112,3,3,0,12,9,4.820284528,23.23514293,12,953.5253168
51,61,112,3,3,1,11,2,4.820284528,23.23514293,10,945.686896
52,60,112,3,3,2,10,9,4.820284528,23.23514293,8,940.8731024
53,59,112,3,3,3,9,2,4.820284528,23.23514293,6,929.5865712
54,58,112,3,3,4,8,9,4.820284528,23.23514293,4,921.7672352
43,70,113,2,3,15,20,4,4.834588127,23.37324236,27,941.2295676
44,69,113,2,3,16,19,6,4.834588127,23.37324236,25,949.5034841
45,68,113,2,3,17,18,4,4.834588127,23.37324236,23,955.6202645
46,67,113,2,3,18,17,6,4.834588127,23.37324236,21,959.6614835
47,66,113,2,3,19,16,4,4.834588127,23.37324236,19,962.315458
48,65,113,2,3,20,15,6,4.834588127,23.37324236,17,963.5495762
49,64,113,2,3,21,14,4,4.834588127,23.37324236,15,963.0910561
50,63,113,3,3,0,13,6,4.834588127,23.37324236,13,961.2697221
51,62,113,3,3,1,12,4,4.834588127,23.37324236,11,956.5762106
52,61,113,3,3,2,11,6,4.834588127,23.37324236,9,949.7239358
53,60,113,3,3,3,10,4,4.834588127,23.37324236,7,941.7140664
54,59,113,3,3,4,9,6,4.834588127,23.37324236,5,932.0158301
55,58,113,3,3,5,8,4,4.834588127,23.37324236,3,920.794399
44,70,114,2,3,16,20,9,4.848807586,23.510935,26,955.9282014
45,69,114,2,3,17,19,2,4.848807586,23.510935,24,960.6349194
46,68,114,2,3,18,18,9,4.848807586,23.510935,22,967.6326384
47,67,114,2,3,19,17,2,4.848807586,23.510935,20,968.2907604
48,66,114,2,3,20,16,9,4.848807586,23.510935,18,972.592539
49,65,114,2,3,21,15,2,4.848807586,23.510935,16,970.3650588
50,64,114,3,3,0,14,9,4.848807586,23.510935,14,971.5726494
51,63,114,3,3,1,13,2,4.848807586,23.510935,12,964.7271774
52,62,114,3,3,2,12,9,4.848807586,23.510935,10,961.337889
53,61,114,3,3,3,11,2,4.848807586,23.510935,8,951.304806
54,60,114,3,3,4,10,9,4.848807586,23.510935,6,944.9694156
55,59,114,3,3,5,9,2,4.848807586,23.510935,4,931.7871054
56,58,114,3,3,6,8,9,4.848807586,23.510935,2,922.224261
44,71,115,2,3,16,21,6,4.862944131,23.64822562,27,959.88361
45,70,115,2,3,17,20,4,4.862944131,23.64822562,25,967.225187
46,69,115,2,3,18,19,6,4.862944131,23.64822562,23,972.639433
47,68,115,2,3,19,18,4,4.862944131,23.64822562,21,976.4138595
48,67,115,2,3,20,17,6,4.862944131,23.64822562,19,978.733398
49,66,115,2,3,21,16,4,4.862944131,23.64822562,17,979.402928
50,65,115,3,3,0,15,6,4.862944131,23.64822562,15,979.118073
51,64,115,3,3,1,14,4,4.862944131,23.64822562,13,975.305294
52,63,115,3,3,2,13,6,4.862944131,23.64822562,11,969.582296
53,62,115,3,3,3,12,4,4.862944131,23.64822562,9,963.0749865
54,61,115,3,3,4,11,6,4.862944131,23.64822562,7,954.611596
44,72,116,2,3,16,22,9,4.876998961,23.78511887,28,965.918544
45,71,116,2,3,17,21,2,4.876998961,23.78511887,26,971.8030268
46,70,116,2,3,18,20,9,4.876998961,23.78511887,24,980.115958
47,69,116,2,3,19,19,2,4.876998961,23.78511887,22,982.0452468
48,68,116,2,3,20,18,9,4.876998961,23.78511887,20,987.4327276
49,67,116,2,3,21,17,2,4.876998961,23.78511887,18,986.1876532
50,66,116,3,3,0,16,9,4.876998961,23.78511887,16,988.6815256
51,65,116,3,3,1,15,2,4.876998961,23.78511887,14,983.1952128
52,64,116,3,3,2,14,9,4.876998961,23.78511887,12,980.854646
53,63,116,3,3,3,13,2,4.876998961,23.78511887,10,972.2291528
54,62,116,3,3,4,12,9,4.876998961,23.78511887,8,967.073034
45,72,117,2,3,17,22,4,4.890973247,23.9216193,27,978.0353622
46,71,117,2,3,18,21,6,4.890973247,23.9216193,25,984.7801431
47,70,117,2,3,19,20,4,4.890973247,23.9216193,23,989.7558255
48,69,117,2,3,20,19,6,4.890973247,23.9216193,21,993.209958
49,68,117,2,3,21,18,4,4.890973247,23.9216193,19,994.9522401
50,67,117,3,3,0,17,6,4.890973247,23.9216193,17,995.624604
51,66,117,3,3,1,16,4,4.890973247,23.9216193,15,993.0840777
52,65,117,3,3,2,15,6,4.890973247,23.9216193,13,988.7576751
53,64,117,3,3,3,14,4,4.890973247,23.9216193,11,983.3183919
54,63,117,3,3,4,13,6,4.890973247,23.9216193,9,976.2828192
55,62,117,3,3,5,12,4,4.890973247,23.9216193,7,967.8082284
45,73,118,2,3,17,23,2,4.904868132,24.05773139,28,982.0967602
46,72,118,2,3,18,22,9,4.904868132,24.05773139,26,991.8159246
47,71,118,2,3,19,21,2,4.904868132,24.05773139,24,995.19902
48,70,118,2,3,20,20,9,4.904868132,24.05773139,22,1001.56453
49,69,118,2,3,21,19,2,4.904868132,24.05773139,20,1001.308706
50,68,118,3,3,0,18,9,4.904868132,24.05773139,18,1004.951024
51,67,118,3,3,1,17,2,4.904868132,24.05773139,16,1000.512041
52,66,118,3,3,2,16,9,4.904868132,24.05773139,14,999.424246
53,65,118,3,3,3,15,2,4.904868132,24.05773139,12,991.9221954
54,64,118,3,3,4,14,9,4.904868132,24.05773139,10,988.2478642
55,63,118,3,3,5,13,2,4.904868132,24.05773139,8,977.7958254
45,74,119,2,3,17,24,4,4.918684734,24.19345952,29,988.1040407
46,73,119,2,3,18,23,6,4.918684734,24.19345952,27,995.9061686
47,72,119,2,3,19,22,4,4.918684734,24.19345952,25,1002.362299
48,71,119,2,3,20,21,6,4.918684734,24.19345952,23,1006.911134
49,70,119,2,3,21,20,4,4.918684734,24.19345952,21,1009.850505
50,69,119,3,3,0,19,6,4.918684734,24.19345952,19,1011.434479
51,68,119,3,3,1,18,4,4.918684734,24.19345952,17,1010.062694
52,67,119,3,3,2,17,6,4.918684734,24.19345952,15,1006.987342
53,66,119,3,3,3,16,4,4.918684734,24.19345952,13,1002.800196
54,65,119,3,3,4,15,6,4.918684734,24.19345952,11,997.034598
55,64,119,3,3,5,14,4,4.918684734,24.19345952,9,989.7628293
46,74,120,2,3,18,24,9,4.932424149,24.32880798,28,1002.849804
47,73,120,2,3,19,23,2,4.932424149,24.32880798,26,1007.439372
48,72,120,2,3,20,22,9,4.932424149,24.32880798,24,1014.96288
49,71,120,2,3,21,21,2,4.932424149,24.32880798,22,1015.9509
50,70,120,3,3,0,20,9,4.932424149,24.32880798,20,1020.53856
51,69,120,3,3,1,19,2,4.932424149,24.32880798,18,1017.0756
52,68,120,3,3,2,18,9,4.932424149,24.32880798,16,1017.238284
53,67,120,3,3,3,17,2,4.932424149,24.32880798,14,1010.84094
54,66,120,3,3,4,16,9,4.932424149,24.32880798,12,1008.483864
55,65,120,3,3,5,15,2,4.932424149,24.32880798,10,999.417732
46,75,121,2,3,18,25,6,4.946087443,24.463781,29,1006.823866
47,74,121,2,3,19,24,4,4.946087443,24.463781,27,1014.262003
48,73,121,2,3,20,23,6,4.946087443,24.463781,25,1020.150661
49,72,121,2,3,21,22,4,4.946087443,24.463781,23,1024.129081
50,71,121,3,3,0,21,6,4.946087443,24.463781,21,1026.708764
51,70,121,3,3,1,20,4,4.946087443,24.463781,19,1026.328945
52,69,121,3,3,2,19,6,4.946087443,24.463781,17,1024.490556
53,68,121,3,3,3,18,4,4.946087443,24.463781,15,1021.410743
54,67,121,3,3,4,17,6,4.946087443,24.463781,13,1016.863745
55,66,121,3,3,5,16,4,4.946087443,24.463781,11,1010.702739
46,76,122,2,3,18,26,9,4.959675664,24.59838269,30,1013.329011
47,75,122,2,3,19,25,2,4.959675664,24.59838269,28,1019.03661
48,74,122,2,3,20,24,9,4.959675664,24.59838269,26,1027.760537
49,73,122,2,3,21,23,2,4.959675664,24.59838269,24,1029.937164
50,72,122,3,3,0,22,9,4.959675664,24.59838269,22,1035.52341
51,71,122,3,3,1,21,2,4.959675664,24.59838269,20,1033.135308
52,70,122,3,3,2,20,9,4.959675664,24.59838269,18,1034.332043
53,69,122,3,3,3,19,2,4.959675664,24.59838269,16,1029.315696
54,68,122,3,3,4,18,9,4.959675664,24.59838269,14,1027.809057
55,67,122,3,3,5,17,2,4.959675664,24.59838269,12,1019.816483
56,66,122,3,3,6,16,9,4.959675664,24.59838269,10,1015.498317
47,76,123,2,3,19,26,4,4.973189833,24.73261712,29,1025.570396
48,75,123,2,3,20,25,6,4.973189833,24.73261712,27,1032.633647
49,74,123,2,3,21,24,4,4.973189833,24.73261712,25,1037.866153
50,73,123,3,3,0,23,6,4.973189833,24.73261712,23,1041.46945
51,72,123,3,3,1,22,4,4.973189833,24.73261712,21,1042.095311
52,71,123,3,3,2,21,6,4.973189833,24.73261712,19,1041.261051
53,70,123,3,3,3,20,4,4.973189833,24.73261712,17,1039.250321
54,69,123,3,3,4,19,6,4.973189833,24.73261712,15,1035.77364
55,68,123,3,3,5,18,4,4.973189833,24.73261712,13,1030.786691
56,67,123,3,3,6,17,6,4.973189833,24.73261712,11,1024.615658
48,76,124,2,3,20,26,9,4.986630952,24.86648825,28,1039.99022
49,75,124,2,3,21,25,2,4.986630952,24.86648825,26,1043.376213
50,74,124,3,3,0,24,9,4.986630952,24.86648825,24,1049.957563
51,73,124,3,3,1,23,2,4.986630952,24.86648825,22,1048.562811
52,72,124,3,3,2,22,9,4.986630952,24.86648825,20,1050.685542
53,71,124,3,3,3,21,2,4.986630952,24.86648825,18,1046.743607
54,70,124,3,3,4,20,9,4.986630952,24.86648825,16,1046.264111
55,69,124,3,3,5,19,2,4.986630952,24.86648825,14,1039.555414
56,68,124,3,3,6,18,9,4.986630952,24.86648825,12,1036.121792
57,67,124,3,3,7,17,2,4.986630952,24.86648825,10,1026.508282
48,77,125,2,3,20,27,6,5,25,29,1044.710188
49,76,125,2,3,21,26,4,5,25,27,1050.992063
50,75,125,3,3,0,25,6,5,25,25,1055.691063
51,74,125,3,3,1,24,4,5,25,23,1057.27015
52,73,125,3,3,2,23,6,5,25,21,1057.254513
53,72,125,3,3,3,22,4,5,25,19,1056.286388
54,71,125,3,3,4,21,6,5,25,17,1053.867375
55,70,125,3,3,5,20,4,5,25,15,1049.975413
56,69,125,3,3,6,19,6,5,25,13,1044.7723
57,68,125,3,3,7,18,4,5,25,11,1038.080475
48,78,126,2,3,20,28,9,5.013297935,25.13315618,30,1051.689152
49,77,126,2,3,21,27,2,5.013297935,25.13315618,28,1056.460444
50,76,126,3,3,0,26,9,5.013297935,25.13315618,26,1063.88386
51,75,126,3,3,1,25,2,5.013297935,25.13315618,24,1063.479514
52,74,126,3,3,2,24,9,5.013297935,25.13315618,22,1066.368202
53,73,126,3,3,3,23,2,5.013297935,25.13315618,20,1063.432175
54,72,126,3,3,4,22,9,5.013297935,25.13315618,18,1063.885725
55,71,126,3,3,5,21,2,5.013297935,25.13315618,16,1058.30768
56,70,126,3,3,6,20,9,5.013297935,25.13315618,14,1055.844556
57,69,126,3,3,7,19,2,5.013297935,25.13315618,12,1047.365777
58,68,126,3,3,8,18,9,5.013297935,25.13315618,10,1042.430521
48,79,127,2,3,20,29,6,5.026525695,25.26596057,31,1056.245932
49,78,127,2,3,21,28,4,5.026525695,25.26596057,29,1063.602292
50,77,127,3,3,0,27,6,5.026525695,25.26596057,27,1069.409621
51,76,127,3,3,1,26,4,5.026525695,25.26596057,25,1071.855997
52,75,127,3,3,2,25,6,5.026525695,25.26596057,23,1072.655843
53,74,127,3,3,3,24,4,5.026525695,25.26596057,21,1072.576214
54,73,127,3,3,4,23,6,5.026525695,25.26596057,19,1071.131538
55,72,127,3,3,5,22,4,5.026525695,25.26596057,17,1068.268336
56,71,127,3,3,6,21,6,5.026525695,25.26596057,15,1064.063912
57,70,127,3,3,7,20,4,5.026525695,25.26596057,13,1058.359732
58,69,127,3,3,8,19,6,5.026525695,25.26596057,11,1051.660609
48,80,128,2,3,20,30,9,5.0396842,25.39841683,32,1062.814298
49,79,128,2,3,21,29,2,5.0396842,25.39841683,30,1068.983821
50,78,128,3,3,0,28,9,5.0396842,25.39841683,28,1077.372787
51,77,128,3,3,1,27,2,5.0396842,25.39841683,26,1077.858867
52,76,128,3,3,2,26,9,5.0396842,25.39841683,24,1081.440461
53,75,128,3,3,3,25,2,5.0396842,25.39841683,22,1079.402355
54,74,128,3,3,4,24,9,5.0396842,25.39841683,20,1080.742502
55,73,128,3,3,5,23,2,5.0396842,25.39841683,18,1076.031398
56,72,128,3,3,6,22,9,5.0396842,25.39841683,16,1074.686438
57,71,128,3,3,7,21,2,5.0396842,25.39841683,14,1067.160371
58,70,128,3,3,8,20,9,5.0396842,25.39841683,12,1063.286515
59,69,128,3,3,9,19,2,5.0396842,25.39841683,10,1053.301005
48,81,129,2,3,20,31,6,5.052774347,25.5305286,33,1066.769512
49,80,129,2,3,21,30,4,5.052774347,25.5305286,31,1075.699911
50,79,129,3,3,0,29,6,5.052774347,25.5305286,29,1082.673277
51,78,129,3,3,1,28,4,5.052774347,25.5305286,27,1085.929714
52,77,129,3,3,2,27,6,5.052774347,25.5305286,25,1087.522864
53,76,129,3,3,3,26,4,5.052774347,25.5305286,23,1088.242813
54,75,129,3,3,4,25,6,5.052774347,25.5305286,21,1087.649362
55,74,129,3,3,5,24,4,5.052774347,25.5305286,19,1085.669999
56,73,129,3,3,6,23,6,5.052774347,25.5305286,17,1082.449462
57,72,129,3,3,7,22,4,5.052774347,25.5305286,15,1077.929792
58,71,129,3,3,8,21,6,5.052774347,25.5305286,13,1072.111402
59,70,129,3,3,9,20,4,5.052774347,25.5305286,11,1064.815123
48,82,130,2,4,20,0,9,5.065797019,25.66229944,34,1072.836284
49,81,130,2,3,21,31,2,5.065797019,25.66229944,32,1080.84288
50,80,130,3,3,0,30,9,5.065797019,25.66229944,30,1090.28621
51,79,130,3,3,1,29,2,5.065797019,25.66229944,28,1091.657333
52,78,130,3,3,2,28,9,5.065797019,25.66229944,26,1095.942263
53,77,130,3,3,3,27,2,5.065797019,25.66229944,24,1094.743143
54,76,130,3,3,4,26,9,5.065797019,25.66229944,22,1096.905082
55,75,130,3,3,5,25,2,5.065797019,25.66229944,20,1093.142024
56,74,130,3,3,6,24,9,5.065797019,25.66229944,18,1092.71669
57,73,130,3,3,7,23,2,5.065797019,25.66229944,16,1086.304947
58,72,130,3,3,8,22,9,5.065797019,25.66229944,14,1083.318132
59,71,130,3,3,9,21,2,5.065797019,25.66229944,12,1074.288345
60,70,130,3,3,10,20,9,5.065797019,25.66229944,10,1068.926768
48,83,131,2,4,20,1,6,5.078753078,25.79373283,35,1075.001772
49,82,131,2,4,21,0,4,5.078753078,25.79373283,33,1087.032026
50,81,131,3,3,0,31,6,5.078753078,25.79373283,31,1095.489897
51,80,131,3,3,1,30,4,5.078753078,25.79373283,29,1099.424378
52,79,131,3,3,2,29,6,5.078753078,25.79373283,27,1101.871641
53,78,131,3,3,3,28,4,5.078753078,25.79373283,25,1103.320999
54,77,131,3,3,4,27,6,5.078753078,25.79373283,23,1103.509508
55,76,131,3,3,5,26,4,5.078753078,25.79373283,21,1102.369153
56,75,131,3,3,6,25,6,5.078753078,25.79373283,19,1100.210194
57,74,131,3,3,7,24,4,5.078753078,25.79373283,17,1096.518156
58,73,131,3,3,8,23,6,5.078753078,25.79373283,15,1091.674994
59,72,131,3,3,9,22,4,5.078753078,25.79373283,13,1085.484851
60,71,131,3,3,10,21,6,5.078753078,25.79373283,11,1078.16989
48,84,132,2,4,20,2,9,5.09164337,25.9248322,36,1078.326757
49,83,132,2,4,21,1,2,5.09164337,25.9248322,34,1089.490538
50,82,132,3,4,0,0,9,5.09164337,25.9248322,32,1102.843183
51,81,132,3,3,1,31,2,5.09164337,25.9248322,30,1105.149566
52,80,132,3,3,2,30,9,5.09164337,25.9248322,28,1109.920139
53,79,132,3,3,3,29,2,5.09164337,25.9248322,26,1109.65309
54,78,132,3,3,4,28,9,5.09164337,25.9248322,24,1112.446223
55,77,132,3,3,5,27,2,5.09164337,25.9248322,22,1109.53759
56,76,132,3,3,6,26,9,5.09164337,25.9248322,20,1110.03746
57,75,132,3,3,7,25,2,5.09164337,25.9248322,18,1104.543779
58,74,132,3,3,8,24,9,5.09164337,25.9248322,16,1102.506544
59,73,132,3,3,9,23,2,5.09164337,25.9248322,14,1094.482976
60,72,132,3,3,10,22,9,5.09164337,25.9248322,12,1089.898973
50,83,133,3,4,0,1,6,5.104468722,26.05560093,33,1105.241837
51,82,133,3,4,1,0,4,5.104468722,26.05560093,31,1112.509117
52,81,133,3,3,2,31,6,5.104468722,26.05560093,29,1115.740392
53,80,133,3,3,3,30,4,5.104468722,26.05560093,27,1117.878207
54,79,133,3,3,4,29,6,5.104468722,26.05560093,25,1118.882144
55,78,133,3,3,5,28,4,5.104468722,26.05560093,23,1118.527154
56,77,133,3,3,6,27,6,5.104468722,26.05560093,21,1117.227385
57,76,133,3,3,7,26,4,5.104468722,26.05560093,19,1114.38592
58,75,133,3,3,8,25,6,5.104468722,26.05560093,17,1110.527403
59,74,133,3,3,9,24,4,5.104468722,26.05560093,15,1105.26442
60,73,133,3,3,10,23,6,5.104468722,26.05560093,13,1098.876856
61,72,133,3,3,11,22,4,5.104468722,26.05560093,11,1091.169785
50,84,134,3,4,0,2,9,5.117229947,26.18604233,34,1108.873035
51,83,134,3,4,1,1,2,5.117229947,26.18604233,32,1115.675933
52,82,134,3,4,2,0,9,5.117229947,26.18604233,30,1123.408323
53,81,134,3,3,3,31,2,5.117229947,26.18604233,28,1124.135675
54,80,134,3,3,4,30,9,5.117229947,26.18604233,26,1127.43572
55,79,134,3,3,5,29,2,5.117229947,26.18604233,24,1125.418698
56,78,134,3,3,6,28,9,5.117229947,26.18604233,22,1126.695195
57,77,134,3,3,7,27,2,5.117229947,26.18604233,20,1122.181499
58,76,134,3,3,8,26,9,5.117229947,26.18604233,18,1121.013394
59,75,134,3,3,9,25,2,5.117229947,26.18604233,16,1113.926148
60,74,134,3,3,10,24,9,5.117229947,26.18604233,14,1110.262239
61,73,134,3,3,11,23,2,5.117229947,26.18604233,12,1100.597355
50,85,135,3,4,0,3,6,5.12992784,26.31615964,35,1111.14284
51,84,135,3,4,1,2,4,5.12992784,26.31615964,33,1119.418569
52,83,135,3,4,2,1,6,5.12992784,26.31615964,31,1126.674684
53,82,135,3,4,3,0,4,5.12992784,26.31615964,29,1131.942722
54,81,135,3,3,4,31,6,5.12992784,26.31615964,27,1133.794571
55,80,135,3,3,5,30,4,5.12992784,26.31615964,25,1134.180806
56,79,135,3,3,6,29,6,5.12992784,26.31615964,23,1133.667158
57,78,135,3,3,7,28,4,5.12992784,26.31615964,21,1131.677622
58,77,135,3,3,8,27,6,5.12992784,26.31615964,19,1128.868124
59,76,135,3,3,9,26,4,5.12992784,26.31615964,17,1124.405334
60,75,135,3,3,10,25,6,5.12992784,26.31615964,15,1118.900736
61,74,135,3,3,11,24,4,5.12992784,26.31615964,13,1111.967096
51,85,136,3,4,1,3,2,5.142563181,26.44595607,34,1122.306449
52,84,136,3,4,2,2,9,5.142563181,26.44595607,32,1131.442494
53,83,136,3,4,3,1,2,5.142563181,26.44595607,30,1135.780091
54,82,136,3,4,4,0,9,5.142563181,26.44595607,28,1141.88169
55,81,136,3,3,5,31,2,5.142563181,26.44595607,26,1141.009033
56,80,136,3,3,6,30,9,5.142563181,26.44595607,24,1142.774898
57,79,136,3,3,7,29,2,5.142563181,26.44595607,22,1139.142963
58,78,136,3,3,8,28,9,5.142563181,26.44595607,20,1138.831686
59,77,136,3,3,9,27,2,5.142563181,26.44595607,18,1132.88121
60,76,136,3,3,10,26,9,5.142563181,26.44595607,16,1129.957727
61,75,136,3,3,11,25,2,5.142563181,26.44595607,14,1121.146015
62,74,136,3,3,12,24,9,5.142563181,26.44595607,12,1116.004644
51,86,137,3,4,1,4,4,5.155136735,26.57543476,35,1125.931267
52,85,137,3,4,2,3,6,5.155136735,26.57543476,33,1134.392291
53,84,137,3,4,3,2,4,5.155136735,26.57543476,31,1140.662452
54,83,137,3,4,4,1,6,5.155136735,26.57543476,29,1145.907251
55,82,137,3,4,5,0,4,5.155136735,26.57543476,27,1149.28726
56,81,137,3,3,6,31,6,5.155136735,26.57543476,25,1149.680546
57,80,137,3,3,7,30,4,5.155136735,26.57543476,23,1148.317656
58,79,137,3,3,8,29,6,5.155136735,26.57543476,21,1146.313209
59,78,137,3,3,9,28,4,5.155136735,26.57543476,19,1142.813914
60,77,137,3,3,10,27,6,5.155136735,26.57543476,17,1138.41372
61,76,137,3,3,11,26,4,5.155136735,26.57543476,15,1132.120269
62,75,137,3,3,12,25,6,5.155136735,26.57543476,13,1125.25672
63,74,137,3,3,13,24,4,5.155136735,26.57543476,11,1116.628611
52,86,138,3,4,2,4,9,5.167649252,26.7045988,34,1138.855847
53,85,138,3,4,3,3,2,5.167649252,26.7045988,32,1144.35741
54,84,138,3,4,4,2,9,5.167649252,26.7045988,30,1151.567399
55,83,138,3,4,5,1,2,5.167649252,26.7045988,28,1153.699831
56,82,138,3,4,6,0,9,5.167649252,26.7045988,26,1158.292264
57,81,138,3,3,7,31,2,5.167649252,26.7045988,24,1155.761523
58,80,138,3,3,8,30,9,5.167649252,26.7045988,22,1156.03163
59,79,138,3,3,9,29,2,5.167649252,26.7045988,20,1150.812291
60,78,138,3,3,10,28,9,5.167649252,26.7045988,18,1148.918255
61,77,138,3,3,11,27,2,5.167649252,26.7045988,16,1141.0331
62,76,138,3,3,12,26,9,5.167649252,26.7045988,14,1136.834147
63,75,138,3,3,13,25,2,5.167649252,26.7045988,12,1126.303712
52,87,139,3,4,2,5,6,5.180101467,26.83345121,35,1141.436252
53,86,139,3,4,3,4,4,5.180101467,26.83345121,33,1148.91979
54,85,139,3,4,4,3,6,5.180101467,26.83345121,31,1155.311066
55,84,139,3,4,5,2,4,5.180101467,26.83345121,29,1159.585218
56,83,139,3,4,6,1,6,5.180101467,26.83345121,27,1163.015697
57,82,139,3,4,7,0,4,5.180101467,26.83345121,25,1164.541819
58,81,139,3,3,8,31,6,5.180101467,26.83345121,23,1163.49483
59,80,139,3,3,9,30,4,5.180101467,26.83345121,21,1160.583391
60,79,139,3,3,10,29,6,5.180101467,26.83345121,19,1156.989324
61,78,139,3,3,11,28,4,5.180101467,26.83345121,17,1151.691075
62,77,139,3,3,12,27,6,5.180101467,26.83345121,15,1145.787925
63,76,139,3,3,13,26,4,5.180101467,26.83345121,13,1138.023399
52,88,140,3,4,2,6,9,5.192494102,26.961995,36,1145.669938
53,87,140,3,4,3,5,2,5.192494102,26.961995,34,1152.12636
54,86,140,3,4,4,4,9,5.192494102,26.961995,32,1160.72425
55,85,140,3,4,5,3,2,5.192494102,26.961995,30,1164.005178
56,84,140,3,4,6,2,9,5.192494102,26.961995,28,1169.441
57,83,140,3,4,7,1,2,5.192494102,26.961995,26,1169.702814
58,82,140,3,4,8,0,9,5.192494102,26.961995,24,1172.68263
59,81,140,3,3,9,31,2,5.192494102,26.961995,22,1168.512282
60,80,140,3,3,10,30,9,5.192494102,26.961995,20,1167.30096
61,79,140,3,3,11,29,2,5.192494102,26.961995,18,1160.473412
62,78,140,3,3,12,28,9,5.192494102,26.961995,16,1156.934954
63,77,140,3,3,13,27,2,5.192494102,26.961995,14,1147.68262
64,76,140,3,3,14,26,9,5.192494102,26.961995,12,1141.696598
53,88,141,3,4,3,6,4,5.204827863,27.09023309,35,1156.518124
54,87,141,3,4,4,5,6,5.204827863,27.09023309,33,1164.006423
55,86,141,3,4,5,4,4,5.204827863,27.09023309,31,1169.504111
56,85,141,3,4,6,3,6,5.204827863,27.09023309,29,1173.976913
57,84,141,3,4,7,2,4,5.204827863,27.09023309,27,1176.391905
58,83,141,3,4,8,1,6,5.204827863,27.09023309,25,1178.11078
59,82,141,3,4,9,0,4,5.204827863,27.09023309,23,1177.911913
60,81,141,3,3,10,31,6,5.204827863,27.09023309,21,1175.306543
61,80,141,3,3,11,30,4,5.204827863,27.09023309,19,1170.855611
62,79,141,3,3,12,29,6,5.204827863,27.09023309,17,1165.484286
63,78,141,3,3,13,28,4,5.204827863,27.09023309,15,1158.693627
64,77,141,3,3,14,27,6,5.204827863,27.09023309,13,1151.209869
65,76,141,3,3,15,26,4,5.204827863,27.09023309,11,1141.74413
53,89,142,3,4,3,7,2,5.217103446,27.21816837,36,1159.465741
54,88,142,3,4,4,6,9,5.217103446,27.21816837,34,1169.110069
55,87,142,3,4,5,5,2,5.217103446,27.21816837,32,1173.612633
56,86,142,3,4,6,4,9,5.217103446,27.21816837,30,1180.157996
57,85,142,3,4,7,3,2,5.217103446,27.21816837,28,1181.557335
58,84,142,3,4,8,2,9,5.217103446,27.21816837,26,1185.28394
59,83,142,3,4,9,1,2,5.217103446,27.21816837,24,1183.755054
60,82,142,3,4,10,0,9,5.217103446,27.21816837,22,1185.136402
61,81,142,3,3,11,31,2,5.217103446,27.21816837,20,1179.545535
62,80,142,3,3,12,30,9,5.217103446,27.21816837,18,1176.603579
63,79,142,3,3,13,29,2,5.217103446,27.21816837,16,1168.148232
64,78,142,3,3,14,28,9,5.217103446,27.21816837,14,1163.01648
54,89,143,3,4,4,7,6,5.229321532,27.34580368,35,1172.154627
55,88,143,3,4,5,6,4,5.229321532,27.34580368,33,1178.84491
56,87,143,3,4,6,5,6,5.229321532,27.34580368,31,1184.324255
57,86,143,3,4,7,4,4,5.229321532,27.34580368,29,1187.776175
58,85,143,3,4,8,3,6,5.229321532,27.34580368,27,1190.42874
59,84,143,3,4,9,2,4,5.229321532,27.34580368,25,1191.108204
60,83,143,3,4,10,1,6,5.229321532,27.34580368,23,1191.25997
61,82,143,3,4,11,0,4,5.229321532,27.34580368,21,1189.435976
62,81,143,3,3,12,31,6,5.229321532,27.34580368,19,1185.210098
63,80,143,3,3,13,30,4,5.229321532,27.34580368,17,1179.151931
65,78,143,3,3,15,28,4,5.229321532,27.34580368,13,1163.765117
66,77,143,3,3,16,27,6,5.229321532,27.34580368,11,1154.732536
54,90,144,3,4,4,8,9,5.241482788,27.47314182,36,1176.895368
55,89,144,3,4,5,7,2,5.241482788,27.47314182,34,1182.512074
56,88,144,3,4,6,6,9,5.241482788,27.47314182,32,1190.225506
57,87,144,3,4,7,5,2,5.241482788,27.47314182,30,1192.525675
58,86,144,3,4,8,4,9,5.241482788,27.47314182,28,1197.325613
59,85,144,3,4,9,3,2,5.241482788,27.47314182,26,1196.861918
60,84,144,3,4,10,2,9,5.241482788,27.47314182,24,1199.077013
61,83,144,3,4,11,1,2,5.241482788,27.47314182,22,1195.962754
62,82,144,3,4,12,0,9,5.241482788,27.47314182,20,1195.72992
63,81,144,3,3,13,31,2,5.241482788,27.47314182,18,1188.601114
64,80,144,3,3,14,30,9,5.241482788,27.47314182,16,1183.959101
65,79,144,3,3,15,29,2,5.241482788,27.47314182,14,1173.785429
66,78,144,3,3,16,28,9,5.241482788,27.47314182,12,1167.204989
67,77,144,3,3,17,27,2,5.241482788,27.47314182,10,1154.462069
54,91,145,3,4,4,9,6,5.253587872,27.60018553,37,1179.587717
55,90,145,3,4,5,8,4,5.253587872,27.60018553,35,1187.366459
56,89,145,3,4,6,7,6,5.253587872,27.60018553,33,1194.04587
57,88,145,3,4,7,6,4,5.253587872,27.60018553,31,1198.582659
58,87,145,3,4,8,5,6,5.253587872,27.60018553,29,1202.032049
59,86,145,3,4,9,4,4,5.253587872,27.60018553,27,1203.808633
60,85,145,3,4,10,3,6,5.253587872,27.60018553,25,1204.832304
61,84,145,3,4,11,2,4,5.253587872,27.60018553,23,1203.885454
62,83,145,3,4,12,1,6,5.253587872,27.60018553,21,1202.487016
63,82,145,3,4,13,0,4,5.253587872,27.60018553,19,1199.044788
64,81,145,3,3,14,31,6,5.253587872,27.60018553,17,1193.197533
65,80,145,3,3,15,30,4,5.253587872,27.60018553,15,1185.888257
66,79,145,3,3,16,29,6,5.253587872,27.60018553,13,1176.948818
67,78,145,3,3,17,28,4,5.253587872,27.60018553,11,1167.043984
54,92,146,3,4,4,10,9,5.265637428,27.72693752,38,1184.120648
55,91,146,3,4,5,9,2,5.265637428,27.72693752,36,1190.693729
56,90,146,3,4,6,8,9,5.265637428,27.72693752,34,1199.467278
57,89,146,3,4,7,7,2,5.265637428,27.72693752,32,1203.039825
58,88,146,3,4,8,6,9,5.265637428,27.72693752,30,1208.662183
59,87,146,3,4,9,5,2,5.265637428,27.72693752,28,1208.92745
60,86,146,3,4,10,4,9,5.265637428,27.72693752,26,1212.397534
61,85,146,3,4,11,3,2,5.265637428,27.72693752,24,1210.14363
62,84,146,3,4,12,2,9,5.265637428,27.72693752,22,1210.903283
63,83,146,3,4,13,1,2,5.265637428,27.72693752,20,1206.242174
64,82,146,3,4,14,0,9,5.265637428,27.72693752,18,1204.428051
65,81,146,3,3,15,31,2,5.265637428,27.72693752,16,1195.32352
66,80,146,3,3,16,30,9,5.265637428,27.72693752,14,1189.332469
67,79,146,3,3,17,29,2,5.265637428,27.72693752,12,1177.23342
68,78,146,3,3,18,28,9,5.265637428,27.72693752,10,1169.534854
55,92,147,3,4,5,10,4,5.277632088,27.85340046,37,1195.374747
56,91,147,3,4,6,9,6,5.277632088,27.85340046,35,1202.936354
57,90,147,3,4,7,8,4,5.277632088,27.85340046,33,1208.568379
58,89,147,3,4,8,7,6,5.277632088,27.85340046,31,1213.121528
59,88,147,3,4,9,6,4,5.277632088,27.85340046,29,1215.76938
60,87,147,3,4,10,5,6,5.277632088,27.85340046,27,1217.689729
61,86,147,3,4,11,4,4,5.277632088,27.85340046,25,1217.802566
62,85,147,3,4,12,3,6,5.277632088,27.85340046,23,1217.24429
63,84,147,3,4,13,2,4,5.277632088,27.85340046,21,1214.740512
64,83,147,3,4,14,1,6,5.277632088,27.85340046,19,1211.77048
65,82,147,3,4,15,0,4,5.277632088,27.85340046,17,1206.373875
66,81,147,3,3,16,31,6,5.277632088,27.85340046,15,1199.044896
67,80,147,3,3,17,30,4,5.277632088,27.85340046,13,1189.823601
68,79,147,3,3,18,29,6,5.277632088,27.85340046,11,1179.891972
69,78,147,3,3,19,28,4,5.277632088,27.85340046,9,1168.476217
55,93,148,3,4,5,11,2,5.289572473,27.97957694,38,1198.436941
56,92,148,3,4,6,10,9,5.289572473,27.97957694,36,1208.288546
57,91,148,3,4,7,9,2,5.289572473,27.97957694,34,1212.670042
58,90,148,3,4,8,8,9,5.289572473,27.97957694,32,1219.577365
59,89,148,3,4,9,7,2,5.289572473,27.97957694,30,1220.932053
60,88,148,3,4,10,6,9,5.289572473,27.97957694,28,1225.022314
61,87,148,3,4,11,5,2,5.289572473,27.97957694,26,1223.697788
62,86,148,3,4,12,4,9,5.289572473,27.97957694,24,1225.385625
63,85,148,3,4,13,3,2,5.289572473,27.97957694,22,1221.564694
64,84,148,3,4,14,2,9,5.289572473,27.97957694,20,1220.75429
65,83,148,3,4,15,1,2,5.289572473,27.97957694,18,1214.239464
66,82,148,3,4,16,0,9,5.289572473,27.97957694,16,1210.779564
67,81,148,3,3,17,31,2,5.289572473,27.97957694,14,1200.128996
68,80,148,3,3,18,30,9,5.289572473,27.97957694,12,1192.834475
69,79,148,3,3,19,29,2,5.289572473,27.97957694,10,1179.338163
56,93,149,3,4,6,11,6,5.301459192,28.10546957,37,1211.645576
58,91,149,3,4,8,9,6,5.301459192,28.10546957,33,1223.920181
59,90,149,3,4,9,8,4,5.301459192,28.10546957,31,1227.507296
60,89,149,3,4,10,7,6,5.301459192,28.10546957,29,1230.061111
61,88,149,3,4,11,6,4,5.301459192,28.10546957,27,1230.967627
62,87,149,3,4,12,5,6,5.301459192,28.10546957,25,1231.256777
63,86,149,3,4,13,4,4,5.301459192,28.10546957,23,1229.779844
64,85,149,3,4,14,3,6,5.301459192,28.10546957,21,1227.683354
65,84,149,3,4,15,2,4,5.301459192,28.10546957,19,1223.26248
66,83,149,3,4,16,1,6,5.301459192,28.10546957,17,1218.685483
67,82,149,3,4,17,0,4,5.301459192,28.10546957,15,1211.854995
68,81,149,3,3,18,31,6,5.301459192,28.10546957,13,1203.168414
56,94,150,3,4,6,12,9,5.313292846,28.23108087,38,1216.776075
57,93,150,3,4,7,11,2,5.313292846,28.23108087,36,1222.415085
58,92,150,3,4,8,10,9,5.313292846,28.23108087,34,1230.16845
59,91,150,3,4,9,9,2,5.313292846,28.23108087,32,1232.83974
60,90,150,3,4,10,8,9,5.313292846,28.23108087,30,1237.436835
61,89,150,3,4,11,7,2,5.313292846,28.23108087,28,1236.571875
62,88,150,3,4,12,6,9,5.313292846,28.23108087,26,1239.243525
63,87,150,3,4,13,5,2,5.313292846,28.23108087,24,1236.202215
64,86,150,3,4,14,4,9,5.313292846,28.23108087,22,1236.391545
65,85,150,3,4,15,3,2,5.313292846,28.23108087,20,1230.95094
66,84,150,3,4,16,2,9,5.313292846,28.23108087,18,1228.372425
67,83,150,3,4,17,1,2,5.313292846,28.23108087,16,1220.226345
68,82,150,3,4,18,0,9,5.313292846,28.23108087,14,1215.32943
58,93,151,3,4,8,11,6,5.325074022,28.35641334,35,1234.617963
59,92,151,3,4,9,10,4,5.325074022,28.35641334,33,1239.390242
60,91,151,3,4,10,9,6,5.325074022,28.35641334,31,1242.771389
61,90,151,3,4,11,8,4,5.325074022,28.35641334,29,1244.432117
62,89,151,3,4,12,7,6,5.325074022,28.35641334,27,1244.839999
63,88,151,3,4,13,6,4,5.325074022,28.35641334,25,1244.13427
64,87,151,3,4,14,5,6,5.325074022,28.35641334,23,1242.887735
65,86,151,3,4,15,4,4,5.325074022,28.35641334,21,1239.540019
66,85,151,3,4,16,3,6,5.325074022,28.35641334,19,1235.886514
67,84,151,3,4,17,2,4,5.325074022,28.35641334,17,1229.974532
68,83,151,3,4,18,1,6,5.325074022,28.35641334,15,1223.835717
69,82,151,3,4,19,0,4,5.325074022,28.35641334,13,1215.558698
59,93,152,3,4,9,11,2,5.336803297,28.48146944,34,1244.439945
60,92,152,3,4,10,10,9,5.336803297,28.48146944,32,1250.049186
61,91,152,3,4,11,9,2,5.336803297,28.48146944,30,1250.371654
62,90,152,3,4,12,8,9,5.336803297,28.48146944,28,1253.097804
63,89,152,3,4,13,7,2,5.336803297,28.48146944,26,1250.440981
64,88,152,3,4,14,6,9,5.336803297,28.48146944,24,1251.477438
65,87,152,3,4,15,5,2,5.336803297,28.48146944,22,1246.705094
66,86,152,3,4,16,4,9,5.336803297,28.48146944,20,1245.323399
67,85,152,3,4,17,3,2,5.336803297,28.48146944,18,1238.027734
68,84,152,3,4,18,2,9,5.336803297,28.48146944,16,1234.140972
69,83,152,3,4,19,1,2,5.336803297,28.48146944,14,1224.578682
70,82,152,3,4,20,0,9,5.336803297,28.48146944,12,1218.346439
59,94,153,3,4,9,12,4,5.348481241,28.60625159,35,1250.321676
60,93,153,3,4,10,11,6,5.348481241,28.60625159,33,1255.30123
61,92,153,3,4,11,10,4,5.348481241,28.60625159,31,1257.836501
62,91,153,3,4,12,9,6,5.348481241,28.60625159,29,1258.966207
63,90,153,3,4,13,8,4,5.348481241,28.60625159,27,1258.991268
64,89,153,3,4,14,7,6,5.348481241,28.60625159,25,1257.724398
65,88,153,3,4,15,6,4,5.348481241,28.60625159,23,1255.372711
66,87,153,3,4,16,5,6,5.348481241,28.60625159,21,1252.419964
67,86,153,3,4,17,4,4,5.348481241,28.60625159,19,1247.506492
68,85,153,3,4,18,3,6,5.348481241,28.60625159,17,1242.178756
69,84,153,3,4,19,2,4,5.348481241,28.60625159,15,1234.902336
71,82,153,3,4,21,0,4,5.348481241,28.60625159,11,1217.740495
59,95,154,3,4,9,13,2,5.360108411,28.73076218,36,1254.684108
60,94,154,3,4,10,12,9,5.360108411,28.73076218,34,1261.621761
61,93,154,3,4,11,11,2,5.360108411,28.73076218,32,1263.526418
62,92,154,3,4,12,10,9,5.360108411,28.73076218,30,1266.933037
63,91,154,3,4,13,9,2,5.360108411,28.73076218,28,1265.433492
64,90,154,3,4,14,8,9,5.360108411,28.73076218,26,1266.619138
65,89,154,3,4,15,7,2,5.360108411,28.73076218,24,1262.287134
66,88,154,3,4,16,6,9,5.360108411,28.73076218,22,1261.742097
67,87,154,3,4,17,5,2,5.360108411,28.73076218,20,1255.205105
68,86,154,3,4,18,4,9,5.360108411,28.73076218,18,1252.388353
69,85,154,3,4,19,3,2,5.360108411,28.73076218,16,1243.428186
70,84,154,3,4,20,2,9,5.360108411,28.73076218,14,1238.150791
59,96,155,3,4,9,14,4,5.371685355,28.85500355,37,1260.311169
60,95,155,3,4,10,13,6,5.371685355,28.85500355,35,1266.397275
61,94,155,3,4,11,12,4,5.371685355,28.85500355,33,1270.271144
62,93,155,3,4,12,11,6,5.371685355,28.85500355,31,1272.739999
63,92,155,3,4,13,10,4,5.371685355,28.85500355,29,1273.58478
64,91,155,3,4,14,9,6,5.371685355,28.85500355,27,1273.054386
65,90,155,3,4,15,8,4,5.371685355,28.85500355,25,1271.452182
66,89,155,3,4,16,7,6,5.371685355,28.85500355,23,1268.575335
67,88,155,3,4,17,6,4,5.371685355,28.85500355,21,1264.676853
68,87,155,3,4,18,5,6,5.371685355,28.85500355,19,1260.063882
69,86,155,3,4,19,4,4,5.371685355,28.85500355,17,1253.69828
70,85,155,3,4,20,3,6,5.371685355,28.85500355,15,1246.792627
71,84,155,3,4,21,2,4,5.371685355,28.85500355,13,1238.05272
59,97,156,3,4,9,15,2,5.383212612,28.97897803,38,1264.416457
60,96,156,3,4,10,14,9,5.383212612,28.97897803,36,1272.386934
61,95,156,3,4,11,13,2,5.383212612,28.97897803,34,1275.569303
62,94,156,3,4,12,12,9,5.383212612,28.97897803,32,1279.980842
63,93,156,3,4,13,11,2,5.383212612,28.97897803,30,1279.920595
64,92,156,3,4,14,10,9,5.383212612,28.97897803,28,1281.590747
65,91,156,3,4,15,9,2,5.383212612,28.97897803,26,1278.364074
66,90,156,3,4,16,8,9,5.383212612,28.97897803,24,1278.02011
67,89,156,3,4,17,7,2,5.383212612,28.97897803,22,1272.246768
68,88,156,3,4,18,6,9,5.383212612,28.97897803,20,1270.13771
69,87,156,3,4,19,5,2,5.383212612,28.97897803,18,1261.978099
70,86,156,3,4,20,4,9,5.383212612,28.97897803,16,1257.626869
71,85,156,3,4,21,3,2,5.383212612,28.97897803,14,1247.278531
72,84,156,3,4,22,2,9,5.383212612,28.97897803,12,1240.616146
59,98,157,3,4,9,16,4,5.394690712,29.10268788,39,1269.473269
60,97,157,3,4,10,15,6,5.394690712,29.10268788,37,1276.750235
61,96,157,3,4,11,14,4,5.394690712,29.10268788,35,1281.770891
62,95,157,3,4,12,13,6,5.394690712,29.10268788,33,1285.369079
63,94,157,3,4,13,12,4,5.394690712,29.10268788,31,1287.368208
64,93,157,3,4,14,11,6,5.394690712,29.10268788,29,1287.95063
65,92,157,3,4,15,10,4,5.394690712,29.10268788,27,1287.108231
66,91,157,3,4,16,9,6,5.394690712,29.10268788,25,1284.986706
67,90,157,3,4,17,8,4,5.394690712,29.10268788,23,1281.612556
68,89,157,3,4,18,7,6,5.394690712,29.10268788,21,1277.410985
69,88,157,3,4,19,6,4,5.394690712,29.10268788,19,1271.924275
70,87,157,3,4,20,5,6,5.394690712,29.10268788,17,1265.852551
71,86,157,3,4,21,4,4,5.394690712,29.10268788,15,1258.09011
73,84,157,3,4,23,2,4,5.394690712,29.10268788,11,1239.681546
60,98,158,3,4,10,16,9,5.406120176,29.22613535,38,1282.162558
61,97,158,3,4,11,15,2,5.406120176,29.22613535,36,1286.651228
62,96,158,3,4,12,14,9,5.406120176,29.22613535,34,1292.014585
63,95,158,3,4,13,13,2,5.406120176,29.22613535,32,1293.250856
64,94,158,3,4,14,12,9,5.406120176,29.22613535,30,1295.888018
65,93,158,3,4,15,11,2,5.406120176,29.22613535,28,1293.886585
66,92,158,3,4,16,10,9,5.406120176,29.22613535,26,1294.040508
67,91,158,3,4,17,9,2,5.406120176,29.22613535,24,1289.038402
68,90,158,3,4,18,8,9,5.406120176,29.22613535,22,1287.372466
69,89,158,3,4,19,7,2,5.406120176,29.22613535,20,1279.989505
70,88,158,3,4,20,6,9,5.406120176,29.22613535,18,1276.513584
71,87,158,3,4,21,5,2,5.406120176,29.22613535,16,1266.933823
72,86,158,3,4,22,4,9,5.406120176,29.22613535,14,1261.041671
60,99,159,3,4,10,17,6,5.417501515,29.34932266,39,1286.122762
61,98,159,3,4,11,16,4,5.417501515,29.34932266,37,1292.170756
62,97,159,3,4,12,15,6,5.417501515,29.34932266,35,1297.041912
63,96,159,3,4,13,14,4,5.417501515,29.34932266,33,1300.095093
64,95,159,3,4,14,13,6,5.417501515,29.34932266,31,1301.831214
65,94,159,3,4,15,12,4,5.417501515,29.34932266,29,1302.019598
66,93,159,3,4,16,11,6,5.417501515,29.34932266,27,1300.871888
67,92,159,3,4,17,10,4,5.417501515,29.34932266,25,1298.251949
68,91,159,3,4,18,9,6,5.417501515,29.34932266,23,1294.701098
69,90,159,3,4,19,8,4,5.417501515,29.34932266,21,1289.928029
70,89,159,3,4,20,7,6,5.417501515,29.34932266,19,1284.408805
71,88,159,3,4,21,6,4,5.417501515,29.34932266,17,1277.501543
72,87,159,3,4,22,5,6,5.417501515,29.34932266,15,1269.863199
73,86,159,3,4,23,4,4,5.417501515,29.34932266,13,1260.667402
60,100,160,3,4,10,18,9,5.428835233,29.47225199,40,1291.194592
61,99,160,3,4,11,17,2,5.428835233,29.47225199,38,1296.582368
62,98,160,3,4,12,16,9,5.428835233,29.47225199,36,1303.138544
63,97,160,3,4,13,15,2,5.428835233,29.47225199,34,1305.61648
64,96,160,3,4,14,14,9,5.428835233,29.47225199,32,1309.282736
65,95,160,3,4,15,13,2,5.428835233,29.47225199,30,1308.394816
66,94,160,3,4,16,12,9,5.428835233,29.47225199,28,1309.448416
67,93,160,3,4,17,11,2,5.428835233,29.47225199,26,1305.376064
68,92,160,3,4,18,10,9,5.428835233,29.47225199,24,1304.275472
69,91,160,3,4,19,9,2,5.428835233,29.47225199,22,1297.729984
70,90,160,3,4,20,8,9,5.428835233,29.47225199,20,1294.809824
71,89,160,3,4,21,7,2,5.428835233,29.47225199,18,1286.134192
72,88,160,3,4,22,6,9,5.428835233,29.47225199,16,1281.020656
73,87,160,3,4,23,5,2,5.428835233,29.47225199,14,1270.123264
74,86,160,3,4,24,4,9,5.428835233,29.47225199,12,1262.846288
61,100,161,3,4,11,18,4,5.440121825,29.59492548,39,1301.84563
62,99,161,3,4,12,17,6,5.440121825,29.59492548,37,1307.64873
63,98,161,3,4,13,16,4,5.440121825,29.59492548,35,1311.985941
64,97,161,3,4,14,15,6,5.440121825,29.59492548,33,1314.918137
65,96,161,3,4,15,14,4,5.440121825,29.59492548,31,1316.091425
66,95,161,3,4,16,13,6,5.440121825,29.59492548,29,1315.902797
67,94,161,3,4,17,12,4,5.440121825,29.59492548,27,1314.261257
68,93,161,3,4,18,11,6,5.440121825,29.59492548,25,1311.483911
69,92,161,3,4,19,10,4,5.440121825,29.59492548,23,1307.398987
70,91,161,3,4,20,9,6,5.440121825,29.59492548,21,1302.552162
71,90,161,3,4,21,8,4,5.440121825,29.59492548,19,1296.497918
72,89,161,3,4,22,7,6,5.440121825,29.59492548,17,1289.469045
73,88,161,3,4,23,6,4,5.440121825,29.59492548,15,1281.14945
75,86,161,3,4,25,4,4,5.440121825,29.59492548,11,1261.649001
62,100,162,3,4,12,18,9,5.451361778,29.71734524,38,1313.427069
63,99,162,3,4,13,17,2,5.451361778,29.71734524,36,1316.988607
64,98,162,3,4,14,16,9,5.451361778,29.71734524,34,1321.764043
65,97,162,3,4,15,15,2,5.451361778,29.71734524,32,1322.580523
66,96,162,3,4,16,14,9,5.451361778,29.71734524,30,1324.099791
67,95,162,3,4,17,13,2,5.451361778,29.71734524,28,1321.176841
68,94,162,3,4,18,12,9,5.451361778,29.71734524,26,1320.688136
69,93,162,3,4,19,11,2,5.451361778,29.71734524,24,1315.049062
70,92,162,3,4,20,10,9,5.451361778,29.71734524,22,1312.610395
71,91,162,3,4,21,9,2,5.451361778,29.71734524,20,1304.838655
72,90,162,3,4,22,8,9,5.451361778,29.71734524,18,1300.39297
73,89,162,3,4,23,7,2,5.451361778,29.71734524,16,1290.223598
74,88,162,3,4,24,6,9,5.451361778,29.71734524,14,1283.659067
62,101,163,3,4,12,19,6,5.462555571,29.83951337,39,1317.718944
63,100,163,3,4,13,18,4,5.462555571,29.83951337,37,1322.910804
64,99,163,3,4,14,17,6,5.462555571,29.83951337,35,1326.943228
65,98,163,3,4,15,16,4,5.462555571,29.83951337,33,1329.368049
66,97,163,3,4,16,15,6,5.462555571,29.83951337,31,1330.370792
67,96,163,3,4,17,14,4,5.462555571,29.83951337,29,1329.585621
68,95,163,3,4,18,13,6,5.462555571,29.83951337,27,1327.592669
69,94,163,3,4,19,12,4,5.462555571,29.83951337,25,1324.371316
70,93,163,3,4,20,11,6,5.462555571,29.83951337,23,1320.154425
71,92,163,3,4,21,10,4,5.462555571,29.83951337,21,1314.869622
72,91,163,3,4,22,9,6,5.462555571,29.83951337,19,1308.565174
73,90,163,3,4,23,8,4,5.462555571,29.83951337,17,1301.048152
74,89,163,3,4,24,7,6,5.462555571,29.83951337,15,1292.639601
75,88,163,3,4,25,6,4,5.462555571,29.83951337,13,1282.951077
62,102,164,3,4,12,20,9,5.473703675,29.96143192,40,1323.115969
63,101,164,3,4,13,19,2,5.473703675,29.96143192,38,1327.64045
64,100,164,3,4,14,18,9,5.473703675,29.96143192,36,1333.319639
65,99,164,3,4,15,17,2,5.473703675,29.96143192,34,1334.948586
66,98,164,3,4,16,16,9,5.473703675,29.96143192,32,1338.028916
67,97,164,3,4,17,15,2,5.473703675,29.96143192,30,1336.259438
68,96,164,3,4,18,14,9,5.473703675,29.96143192,28,1336.439132
69,95,164,3,4,19,13,2,5.473703675,29.96143192,26,1331.623158
70,94,164,3,4,20,12,9,5.473703675,29.96143192,24,1329.944044
71,93,164,3,4,21,11,2,5.473703675,29.96143192,22,1322.791905
72,92,164,3,4,22,10,9,5.473703675,29.96143192,20,1319.185529
73,91,164,3,4,23,9,2,5.473703675,29.96143192,18,1309.867639
74,90,164,3,4,24,8,9,5.473703675,29.96143192,16,1304.038046
75,89,164,3,4,25,7,2,5.473703675,29.96143192,14,1292.492577
76,88,164,3,4,26,6,9,5.473703675,29.96143192,12,1284.662512
63,102,165,3,4,13,20,4,5.484806552,30.08310292,39,1333.208729
64,101,165,3,4,14,19,6,5.484806552,30.08310292,37,1338.223062
65,100,165,3,4,15,18,4,5.484806552,30.08310292,35,1341.503774
66,99,165,3,4,16,17,6,5.484806552,30.08310292,33,1343.74487
67,98,165,3,4,17,16,4,5.484806552,30.08310292,31,1344.248252
68,97,165,3,4,18,15,6,5.484806552,30.08310292,29,1343.089242
69,96,165,3,4,19,14,4,5.484806552,30.08310292,27,1340.715569
70,95,165,3,4,20,13,6,5.484806552,30.08310292,25,1337.298584
71,94,165,3,4,21,12,4,5.484806552,30.08310292,23,1332.66309
72,93,165,3,4,22,11,6,5.484806552,30.08310292,21,1327.074012
73,92,165,3,4,23,10,4,5.484806552,30.08310292,19,1320.504026
74,91,165,3,4,24,9,6,5.484806552,30.08310292,17,1312.735116
75,90,165,3,4,25,8,4,5.484806552,30.08310292,15,1303.750817
64,102,166,3,4,14,20,9,5.49586466,30.20452836,38,1344.139516
65,101,166,3,4,15,19,2,5.49586466,30.20452836,36,1346.795018
66,100,166,3,4,16,18,9,5.49586466,30.20452836,34,1350.788364
67,99,166,3,4,17,17,2,5.49586466,30.20452836,32,1350.491888
68,98,166,3,4,18,16,9,5.49586466,30.20452836,30,1351.563351
69,97,166,3,4,19,15,2,5.49586466,30.20452836,28,1347.743326
70,96,166,3,4,20,14,9,5.49586466,30.20452836,26,1346.668211
71,95,166,3,4,21,13,2,5.49586466,30.20452836,24,1340.31315
72,94,166,3,4,22,12,9,5.49586466,30.20452836,22,1337.368808
73,93,166,3,4,23,11,2,5.49586466,30.20452836,20,1328.825252
74,92,166,3,4,24,10,9,5.49586466,30.20452836,18,1323.832587
75,91,166,3,4,25,9,2,5.49586466,30.20452836,16,1313.000107
76,90,166,3,4,26,8,9,5.49586466,30.20452836,14,1305.811959
64,103,167,3,4,14,21,6,5.506878446,30.32571022,39,1348.615648
65,102,167,3,4,15,20,4,5.506878446,30.32571022,37,1352.940647
66,101,167,3,4,16,19,6,5.506878446,30.32571022,35,1356.186659
67,100,167,3,4,17,18,4,5.506878446,30.32571022,33,1357.772324
68,99,167,3,4,18,17,6,5.506878446,30.32571022,31,1357.999778
69,98,167,3,4,19,16,4,5.506878446,30.32571022,29,1356.471294
70,97,167,3,4,20,15,6,5.506878446,30.32571022,27,1353.735734
71,96,167,3,4,21,14,4,5.506878446,30.32571022,25,1349.889757
72,95,167,3,4,22,13,6,5.506878446,30.32571022,23,1345.048895
73,94,167,3,4,23,12,4,5.506878446,30.32571022,21,1339.149854
74,93,167,3,4,24,11,6,5.506878446,30.32571022,19,1332.109652
76,91,167,3,4,26,9,6,5.506878446,30.32571022,15,1314.950602
77,90,167,3,4,27,8,4,5.506878446,30.32571022,13,1304.741842
65,103,168,3,4,15,21,2,5.517848353,30.44665044,38,1357.910064
66,102,168,3,4,16,20,9,5.517848353,30.44665044,36,1362.904922
67,101,168,3,4,17,19,2,5.517848353,30.44665044,34,1363.623425
68,100,168,3,4,18,18,9,5.517848353,30.44665044,32,1365.77107
69,99,168,3,4,19,17,2,5.517848353,30.44665044,30,1363.311869
70,98,168,3,4,20,16,9,5.517848353,30.44665044,28,1362.797016
71,97,168,3,4,21,15,2,5.517848353,30.44665044,26,1357.507637
72,96,168,3,4,22,14,9,5.517848353,30.44665044,24,1355.013005
73,95,168,3,4,23,13,2,5.517848353,30.44665044,22,1347.264022
74,94,168,3,4,24,12,9,5.517848353,30.44665044,20,1342.980694
75,93,168,3,4,25,11,2,5.517848353,30.44665044,18,1333.100294
76,92,168,3,4,26,10,9,5.517848353,30.44665044,16,1326.518054
77,91,168,3,4,27,9,2,5.517848353,30.44665044,14,1314.406951
78,90,168,3,4,28,8,9,5.517848353,30.44665044,12,1305.968446
67,102,169,3,4,17,20,4,5.528774814,30.56735094,35,1370.431512
68,101,169,3,4,18,19,6,5.528774814,30.56735094,33,1371.774318
69,100,169,3,4,19,18,4,5.528774814,30.56735094,31,1371.345464
70,99,169,3,4,20,17,6,5.528774814,30.56735094,29,1369.663981
71,98,169,3,4,21,16,4,5.528774814,30.56735094,27,1366.588638
72,97,169,3,4,22,15,6,5.528774814,30.56735094,25,1362.440668
73,96,169,3,4,23,14,4,5.528774814,30.56735094,23,1357.231851
74,95,169,3,4,24,13,6,5.528774814,30.56735094,21,1351.076939
75,94,169,3,4,25,12,4,5.528774814,30.56735094,19,1343.785975
76,93,169,3,4,26,11,6,5.528774814,30.56735094,17,1335.317368
77,92,169,3,4,27,10,4,5.528774814,30.56735094,15,1325.905454
67,103,170,3,4,17,21,2,5.539658257,30.6878136,36,1375.944334
68,102,170,3,4,18,20,9,5.539658257,30.6878136,34,1379.031993
69,101,170,3,4,19,19,2,5.539658257,30.6878136,32,1377.937448
70,100,170,3,4,20,18,9,5.539658257,30.6878136,30,1378.123717
71,99,170,3,4,21,17,2,5.539658257,30.6878136,28,1373.883662
72,98,170,3,4,22,16,9,5.539658257,30.6878136,26,1372.048954
73,97,170,3,4,23,15,2,5.539658257,30.6878136,24,1365.150405
74,96,170,3,4,24,14,9,5.539658257,30.6878136,22,1361.521194
75,95,170,3,4,25,13,2,5.539658257,30.6878136,20,1352.35204
76,94,170,3,4,26,12,9,5.539658257,30.6878136,18,1346.591386
78,92,170,3,4,28,10,9,5.539658257,30.6878136,14,1327.400205
68,103,171,3,4,18,21,6,5.550499103,30.80804029,35,1384.713608
69,102,171,3,4,19,20,4,5.550499103,30.80804029,33,1385.42372
70,101,171,3,4,20,19,6,5.550499103,30.80804029,31,1384.737925
71,100,171,3,4,21,18,4,5.550499103,30.80804029,29,1382.477219
72,99,171,3,4,22,17,6,5.550499103,30.80804029,27,1379.297748
73,98,171,3,4,23,16,4,5.550499103,30.80804029,25,1374.804329
74,97,171,3,4,24,15,6,5.550499103,30.80804029,23,1369.387802
75,96,171,3,4,25,14,4,5.550499103,30.80804029,21,1362.76964
76,95,171,3,4,26,13,6,5.550499103,30.80804029,19,1355.03425
77,94,171,3,4,27,12,4,5.550499103,30.80804029,17,1346.366705
78,93,171,3,4,28,11,6,5.550499103,30.80804029,15,1336.638891
79,92,171,3,4,29,10,4,5.550499103,30.80804029,13,1325.95228
68,104,172,3,4,18,22,9,5.561297767,30.92803285,36,1391.549694
69,103,172,3,4,19,21,2,5.561297767,30.92803285,34,1391.658312
70,102,172,3,4,20,20,9,5.561297767,30.92803285,32,1392.757874
71,101,172,3,4,21,19,2,5.561297767,30.92803285,30,1389.456145
72,100,172,3,4,22,18,9,5.561297767,30.92803285,28,1388.339951
73,99,172,3,4,23,17,2,5.561297767,30.92803285,26,1382.485363
74,98,172,3,4,24,16,9,5.561297767,30.92803285,24,1379.47022
75,97,172,3,4,25,15,2,5.561297767,30.92803285,22,1371.157512
76,96,172,3,4,26,14,9,5.561297767,30.92803285,20,1366.051967
77,95,172,3,4,27,13,2,5.561297767,30.92803285,18,1355.405356
78,94,172,3,4,28,12,9,5.561297767,30.92803285,16,1348.350312
79,93,172,3,4,29,11,2,5.561297767,30.92803285,14,1335.779296
80,92,172,3,4,30,10,9,5.561297767,30.92803285,12,1326.740301
69,104,173,3,4,19,22,4,5.572054656,31.04779308,35,1398.612151
70,103,173,3,4,20,21,6,5.572054656,31.04779308,33,1399.124975
71,102,173,3,4,21,20,4,5.572054656,31.04779308,31,1397.672398
72,101,173,3,4,22,19,6,5.572054656,31.04779308,29,1395.420837
73,100,173,3,4,23,18,4,5.572054656,31.04779308,27,1391.623245
74,99,173,3,4,24,17,6,5.572054656,31.04779308,25,1387.17173
75,98,173,3,4,25,16,4,5.572054656,31.04779308,23,1381.215876
76,97,173,3,4,26,15,6,5.572054656,31.04779308,21,1374.317899
77,96,173,3,4,27,14,4,5.572054656,31.04779308,19,1366.365764
78,95,173,3,4,28,13,6,5.572054656,31.04779308,17,1357.251709
79,94,173,3,4,29,12,4,5.572054656,31.04779308,15,1347.36462
69,105,174,3,4,19,23,2,5.582770172,31.16732279,36,1404.291917
70,104,174,3,4,20,22,9,5.582770172,31.16732279,34,1406.589569
71,103,174,3,4,21,21,2,5.582770172,31.16732279,32,1404.432996
72,102,174,3,4,22,20,9,5.582770172,31.16732279,30,1403.924933
73,101,174,3,4,23,19,2,5.582770172,31.16732279,28,1399.038787
74,100,174,3,4,24,18,9,5.582770172,31.16732279,26,1396.742753
75,99,174,3,4,25,17,2,5.582770172,31.16732279,24,1389.406426
76,98,174,3,4,26,16,9,5.582770172,31.16732279,22,1384.946353
77,97,174,3,4,27,15,2,5.582770172,31.16732279,20,1374.95456
78,96,174,3,4,28,14,9,5.582770172,31.16732279,18,1368.703888
80,94,174,3,4,30,12,9,5.582770172,31.16732279,14,1348.462607
69,106,175,3,4,19,24,4,5.59344471,31.28662373,37,1410.809278
70,105,175,3,4,20,23,6,5.59344471,31.28662373,35,1412.411928
71,104,175,3,4,21,22,4,5.59344471,31.28662373,33,1412.09971
72,103,175,3,4,22,21,6,5.59344471,31.28662373,31,1410.633438
73,102,175,3,4,23,20,4,5.59344471,31.28662373,29,1407.77798
74,101,175,3,4,24,19,6,5.59344471,31.28662373,27,1404.219775
75,100,175,3,4,25,18,4,5.59344471,31.28662373,25,1399.09294
76,99,175,3,4,26,17,6,5.59344471,31.28662373,23,1393.127645
77,98,175,3,4,27,16,4,5.59344471,31.28662373,21,1385.63446
78,97,175,3,4,28,15,6,5.59344471,31.28662373,19,1377.16628
79,96,175,3,4,29,14,4,5.59344471,31.28662373,17,1368.078933
80,95,175,3,4,30,13,6,5.59344471,31.28662373,15,1357.862345
69,107,176,3,4,19,25,2,5.604078661,31.40569764,38,1415.941366
70,106,176,3,4,20,24,9,5.604078661,31.40569764,36,1419.279013
71,105,176,3,4,21,23,2,5.604078661,31.40569764,34,1418.387678
72,104,176,3,4,22,22,9,5.604078661,31.40569764,32,1418.79943
73,103,176,3,4,23,21,2,5.604078661,31.40569764,30,1414.806026
74,102,176,3,4,24,20,9,5.604078661,31.40569764,28,1413.299906
75,101,176,3,4,25,19,2,5.604078661,31.40569764,26,1406.938843
76,100,176,3,4,26,18,9,5.604078661,31.40569764,24,1403.224786
77,99,176,3,4,27,17,2,5.604078661,31.40569764,22,1394.193187
78,98,176,3,4,28,16,9,5.604078661,31.40569764,20,1388.462838
79,97,176,3,4,29,15,2,5.604078661,31.40569764,18,1377.267531
80,96,176,3,4,30,14,9,5.604078661,31.40569764,16,1369.748864
81,95,176,3,4,31,13,2,5.604078661,31.40569764,14,1356.597141
70,107,177,3,4,20,25,6,5.614672408,31.52454625,37,1424.845416
71,106,177,3,4,21,24,4,5.614672408,31.52454625,35,1425.460562
72,105,177,3,4,22,23,6,5.614672408,31.52454625,33,1425.175061
73,104,177,3,4,23,22,4,5.614672408,31.52454625,31,1423.226715
74,103,177,3,4,24,21,6,5.614672408,31.52454625,29,1420.431354
75,102,177,3,4,25,20,4,5.614672408,31.52454625,27,1416.216453
76,101,177,3,4,26,19,6,5.614672408,31.52454625,25,1411.121367
77,100,177,3,4,27,18,4,5.614672408,31.52454625,23,1404.430006
78,99,177,3,4,28,17,6,5.614672408,31.52454625,21,1396.970659
79,98,177,3,4,29,16,4,5.614672408,31.52454625,19,1388.363627
80,97,177,3,4,30,15,6,5.614672408,31.52454625,17,1378.811362
81,96,177,3,4,31,14,4,5.614672408,31.52454625,15,1368.593294
70,108,178,3,4,20,26,9,5.625226328,31.64317125,38,1431.607471
71,107,178,3,4,21,25,2,5.625226328,31.64317125,36,1431.485861
72,106,178,3,4,22,24,9,5.625226328,31.64317125,34,1432.800996
74,104,178,3,4,24,22,9,5.625226328,31.64317125,30,1429.207995
75,103,178,3,4,25,21,2,5.625226328,31.64317125,28,1423.672053
76,102,178,3,4,26,20,9,5.625226328,31.64317125,26,1420.780478
77,101,178,3,4,27,19,2,5.625226328,31.64317125,24,1412.708214
78,100,178,3,4,28,18,9,5.625226328,31.64317125,22,1407.669034
79,99,178,3,4,29,17,2,5.625226328,31.64317125,20,1397.192239
80,98,178,3,4,30,16,9,5.625226328,31.64317125,18,1390.422205
82,96,178,4,4,0,14,9,5.625226328,31.64317125,14,1368.96879
71,108,179,3,4,21,26,4,5.635740795,31.7615743,37,1438.278318
72,107,179,3,4,22,25,6,5.635740795,31.7615743,35,1438.899985
73,106,179,3,4,23,24,4,5.635740795,31.7615743,33,1438.012055
74,105,179,3,4,24,23,6,5.635740795,31.7615743,31,1436.167496
75,104,179,3,4,25,22,4,5.635740795,31.7615743,29,1432.674221
76,103,179,3,4,26,21,6,5.635740795,31.7615743,27,1428.327708
77,102,179,3,4,27,20,4,5.635740795,31.7615743,25,1422.606939
78,101,179,3,4,28,19,6,5.635740795,31.7615743,23,1416.010986
79,100,179,3,4,29,18,4,5.635740795,31.7615743,21,1407.949095
80,99,179,3,4,30,17,6,5.635740795,31.7615743,19,1399.111095
81,98,179,3,4,31,16,4,5.635740795,31.7615743,17,1389.665462
82,97,179,4,4,0,15,6,5.635740795,31.7615743,15,1378.561877
71,109,180,3,4,21,27,2,5.646216173,31.87975708,38,1443.967092
72,108,180,3,4,22,26,9,5.646216173,31.87975708,36,1446.287742
73,107,180,3,4,23,25,2,5.646216173,31.87975708,34,1444.659552
74,106,180,3,4,24,24,9,5.646216173,31.87975708,32,1444.579812
75,105,180,3,4,25,23,2,5.646216173,31.87975708,30,1439.998596
76,104,180,3,4,26,22,9,5.646216173,31.87975708,28,1437.735078
77,103,180,3,4,27,21,2,5.646216173,31.87975708,26,1430.574066
78,102,180,3,4,28,20,9,5.646216173,31.87975708,24,1426.244058
79,101,180,3,4,29,19,2,5.646216173,31.87975708,22,1416.657492
80,100,180,3,4,30,18,9,5.646216173,31.87975708,20,1410.499998
81,99,180,3,4,31,17,2,5.646216173,31.87975708,18,1398.85758
82,98,180,4,4,0,16,9,5.646216173,31.87975708,16,1390.625874
71,110,181,3,4,21,28,4,5.656652826,31.99772119,39,1450.159348
72,109,181,3,4,22,27,6,5.656652826,31.99772119,37,1451.982543
73,108,181,3,4,23,26,4,5.656652826,31.99772119,35,1452.236305
74,107,181,3,4,24,25,6,5.656652826,31.99772119,33,1451.248841
75,106,181,3,4,25,24,4,5.656652826,31.99772119,31,1448.749955
76,105,181,3,4,26,23,6,5.656652826,31.99772119,29,1445.00016
77,104,181,3,4,27,22,4,5.656652826,31.99772119,27,1440.13088
78,103,181,3,4,28,21,6,5.656652826,31.99772119,25,1434.267005
79,102,181,3,4,29,20,4,5.656652826,31.99772119,23,1426.974298
80,101,181,3,4,30,19,6,5.656652826,31.99772119,21,1418.981935
81,100,181,3,4,31,18,4,5.656652826,31.99772119,19,1410.337212
82,99,181,4,4,0,17,6,5.656652826,31.99772119,17,1399.866742
72,110,182,3,4,22,28,9,5.667051108,32.11546826,38,1458.700534
73,109,182,3,4,23,27,2,5.667051108,32.11546826,36,1458.299242
74,108,182,3,4,24,26,9,5.667051108,32.11546826,34,1459.332347
75,107,182,3,4,25,25,2,5.667051108,32.11546826,32,1455.750005
76,106,182,3,4,26,24,9,5.667051108,32.11546826,30,1454.130623
77,105,182,3,4,27,23,2,5.667051108,32.11546826,28,1447.790854
78,104,182,3,4,28,22,9,5.667051108,32.11546826,26,1444.125246
79,103,182,3,4,29,21,2,5.667051108,32.11546826,24,1435.478444
80,102,182,3,4,30,20,9,5.667051108,32.11546826,22,1429.969013
81,101,182,3,4,31,19,2,5.667051108,32.11546826,20,1418.936992
82,100,182,4,4,0,18,9,5.667051108,32.11546826,18,1411.651987
71,112,183,3,4,21,30,4,5.677411371,32.23299987,41,1461.220688
72,111,183,3,4,22,29,6,5.677411371,32.23299987,39,1464.005765
73,110,183,3,4,23,28,4,5.677411371,32.23299987,37,1465.23342
74,109,183,3,4,24,27,6,5.677411371,32.23299987,35,1465.523182
75,108,183,3,4,25,26,4,5.677411371,32.23299987,33,1464.184848
76,107,183,3,4,26,25,6,5.677411371,32.23299987,31,1461.256592
77,106,183,3,4,27,24,4,5.677411371,32.23299987,29,1457.012621
78,105,183,3,4,28,23,6,5.677411371,32.23299987,27,1451.80133
79,104,183,3,4,29,22,4,5.677411371,32.23299987,25,1445.437285
80,103,183,3,4,30,21,6,5.677411371,32.23299987,23,1438.268096
81,102,183,3,4,31,20,4,5.677411371,32.23299987,21,1430.26836
82,101,183,4,4,0,19,6,5.677411371,32.23299987,19,1420.478757
72,112,184,3,4,22,30,9,5.68773396,32.3503176,40,1470.292995
73,111,184,3,4,23,29,2,5.68773396,32.3503176,38,1470.850644
74,110,184,3,4,24,28,9,5.68773396,32.3503176,36,1472.934297
75,109,184,3,4,25,27,2,5.68773396,32.3503176,34,1470.666313
76,108,184,3,4,26,26,9,5.68773396,32.3503176,32,1469.916715
77,107,184,3,4,27,25,2,5.68773396,32.3503176,30,1464.492653
78,106,184,3,4,28,24,9,5.68773396,32.3503176,28,1461.431942
79,105,184,3,4,29,23,2,5.68773396,32.3503176,26,1453.635825
80,104,184,3,4,30,22,9,5.68773396,32.3503176,24,1448.879554
81,103,184,3,4,31,21,2,5.68773396,32.3503176,22,1438.635777
82,102,184,4,4,0,20,9,5.68773396,32.3503176,20,1432.021658
72,113,185,3,4,22,31,6,5.698019215,32.46742298,41,1475.184654
73,112,185,3,4,23,30,4,5.698019215,32.46742298,39,1477.476878
74,111,185,3,4,24,29,6,5.698019215,32.46742298,37,1478.688036
75,110,185,3,4,25,28,4,5.698019215,32.46742298,35,1478.336869
76,109,185,3,4,26,27,6,5.698019215,32.46742298,33,1476.54137
77,108,185,3,4,27,26,4,5.698019215,32.46742298,31,1473.288681
78,107,185,3,4,28,25,6,5.698019215,32.46742298,29,1468.858912
79,106,185,3,4,29,24,4,5.698019215,32.46742298,27,1463.246585
80,105,185,3,4,30,23,6,5.698019215,32.46742298,25,1456.789734
81,104,185,3,4,31,22,4,5.698019215,32.46742298,23,1449.581486
82,103,185,4,4,0,21,6,5.698019215,32.46742298,21,1440.582605
72,114,186,3,4,22,32,9,5.708267473,32.58431755,42,1481.360395
73,113,186,3,4,23,31,2,5.708267473,32.58431755,40,1482.76144
74,112,186,3,4,24,30,9,5.708267473,32.58431755,38,1485.880084
75,111,186,3,4,25,29,2,5.708267473,32.58431755,36,1484.516462
76,110,186,3,4,26,28,9,5.708267473,32.58431755,34,1484.806826
77,109,186,3,4,27,27,2,5.708267473,32.58431755,32,1480.196798
78,108,186,3,4,28,26,9,5.708267473,32.58431755,30,1478.106548
79,107,186,3,4,29,25,2,5.708267473,32.58431755,28,1471.174607
80,106,186,3,4,30,24,9,5.708267473,32.58431755,26,1467.216453
81,105,186,3,4,31,23,2,5.708267473,32.58431755,24,1457.777995
82,104,186,4,4,0,22,9,5.708267473,32.58431755,22,1451.793612
83,103,186,4,4,1,21,2,5.708267473,32.58431755,20,1439.475855
84,102,186,4,4,2,20,9,5.708267473,32.58431755,18,1431.446477
73,114,187,3,4,23,32,4,5.718479065,32.70100282,41,1489.1207
74,113,187,3,4,24,31,6,5.718479065,32.70100282,39,1491.346842
75,112,187,3,4,25,30,4,5.718479065,32.70100282,37,1491.877005
76,111,187,3,4,26,29,6,5.718479065,32.70100282,35,1491.097122
77,110,187,3,4,27,28,4,5.718479065,32.70100282,33,1488.64514
78,109,187,3,4,28,27,6,5.718479065,32.70100282,31,1484.998771
79,108,187,3,4,29,26,4,5.718479065,32.70100282,29,1480.55984
80,107,187,3,4,30,25,6,5.718479065,32.70100282,27,1474.867224
81,106,187,3,4,31,24,4,5.718479065,32.70100282,25,1468.410955
82,105,187,4,4,0,23,6,5.718479065,32.70100282,23,1460.170987
83,104,187,4,4,1,22,4,5.718479065,32.70100282,21,1450.784952
84,103,187,4,4,2,21,6,5.718479065,32.70100282,19,1440.795524
74,114,188,3,4,24,32,9,5.728654316,32.81748027,40,1498.182002
75,113,188,3,4,25,31,2,5.728654316,32.81748027,38,1497.748643
76,112,188,3,4,26,30,9,5.728654316,32.81748027,36,1499.086733
77,111,188,3,4,27,29,2,5.728654316,32.81748027,34,1495.512026
78,110,188,3,4,28,28,9,5.728654316,32.81748027,32,1494.205708
79,109,188,3,4,29,27,2,5.728654316,32.81748027,30,1487.973696
80,108,188,3,4,30,26,9,5.728654316,32.81748027,28,1485.018392
81,107,188,3,4,31,25,2,5.728654316,32.81748027,26,1476.374096
82,106,188,4,4,0,24,9,5.728654316,32.81748027,24,1471.066367
83,105,188,4,4,1,23,2,5.728654316,32.81748027,22,1459.667795
84,104,188,4,4,2,22,9,5.728654316,32.81748027,20,1452.235027
75,114,189,3,4,25,32,4,5.738793548,32.93375139,39,1504.782185
76,113,189,3,4,26,31,6,5.738793548,32.93375139,37,1505.007548
77,112,189,3,4,27,30,4,5.738793548,32.93375139,35,1503.688045
78,111,189,3,4,28,29,6,5.738793548,32.93375139,33,1500.925451
79,110,189,3,4,29,28,4,5.738793548,32.93375139,31,1497.255656
80,109,189,3,4,30,27,6,5.738793548,32.93375139,29,1492.517729
81,108,189,3,4,31,26,4,5.738793548,32.93375139,27,1486.725106
82,107,189,4,4,0,25,6,5.738793548,32.93375139,25,1479.170681
83,106,189,4,4,1,24,4,5.738793548,32.93375139,23,1470.608981
84,105,189,4,4,2,23,6,5.738793548,32.93375139,21,1461.183967
74,116,190,3,4,24,34,9,5.748897079,33.04981762,42,1510.025589
75,115,190,3,4,25,33,2,5.748897079,33.04981762,40,1510.457421
76,114,190,3,4,26,32,9,5.748897079,33.04981762,38,1512.799893
77,113,190,3,4,27,31,2,5.748897079,33.04981762,36,1510.063323
78,112,190,3,4,28,30,9,5.748897079,33.04981762,34,1509.833879
79,111,190,3,4,29,29,2,5.748897079,33.04981762,32,1504.578555
80,110,190,3,4,30,28,9,5.748897079,33.04981762,30,1502.333306
81,109,190,3,4,31,27,2,5.748897079,33.04981762,28,1494.546555
82,108,190,4,4,0,26,9,5.748897079,33.04981762,26,1489.814586
83,107,190,4,4,1,25,2,5.748897079,33.04981762,24,1479.211541
84,106,190,4,4,2,24,9,5.748897079,33.04981762,22,1472.395994
74,117,191,3,4,24,35,6,5.75896522,33.16568041,43,1514.904257
75,116,191,3,4,25,34,4,5.75896522,33.16568041,41,1517.296131
76,115,191,3,4,26,33,6,5.75896522,33.16568041,39,1518.558622
77,114,191,3,4,27,32,4,5.75896522,33.16568041,37,1518.08985
78,113,191,3,4,28,31,6,5.75896522,33.16568041,35,1516.297029
79,112,191,3,4,29,30,4,5.75896522,33.16568041,33,1513.614243
80,111,191,3,4,30,29,6,5.75896522,33.16568041,31,1509.625838
81,110,191,3,4,31,28,4,5.75896522,33.16568041,29,1504.5346
82,109,191,4,4,0,27,6,5.75896522,33.16568041,27,1497.760536
83,108,191,4,4,1,26,4,5.75896522,33.16568041,25,1489.926308
84,107,191,4,4,2,25,6,5.75896522,33.16568041,23,1480.973336
85,106,191,4,4,3,24,4,5.75896522,33.16568041,21,1471.25835
75,117,192,3,4,25,35,2,5.768998281,33.28134117,42,1522.605869
76,116,192,3,4,26,34,9,5.768998281,33.28134117,40,1526.116992
77,115,192,3,4,27,33,2,5.768998281,33.28134117,38,1524.287981
78,114,192,3,4,28,32,9,5.768998281,33.28134117,36,1524.958522
79,113,192,3,4,29,31,2,5.768998281,33.28134117,34,1520.659834
80,112,192,3,4,30,30,9,5.768998281,33.28134117,32,1519.116787
81,111,192,3,4,31,29,2,5.768998281,33.28134117,30,1512.195206
82,110,192,4,4,0,28,9,5.768998281,33.28134117,28,1508.092454
83,109,192,4,4,1,27,2,5.768998281,33.28134117,26,1498.292813
84,108,192,4,4,2,26,9,5.768998281,33.28134117,24,1492.042406
85,107,192,4,4,3,25,2,5.768998281,33.28134117,22,1480.267834
75,118,193,3,4,25,36,4,5.778996565,33.3968013,43,1529.319995
76,117,193,3,4,26,35,6,5.778996565,33.3968013,41,1531.700419
77,116,193,3,4,27,34,4,5.778996565,33.3968013,39,1532.059978
78,115,193,3,4,28,33,6,5.778996565,33.3968013,37,1531.220988
79,114,193,3,4,29,32,4,5.778996565,33.3968013,35,1529.363806
80,113,193,3,4,30,31,6,5.778996565,33.3968013,33,1526.238789
81,112,193,3,4,31,30,4,5.778996565,33.3968013,31,1521.871489
82,111,193,4,4,0,29,6,5.778996565,33.3968013,29,1515.841184
83,110,193,4,4,1,28,4,5.778996565,33.3968013,27,1508.714157
84,109,193,4,4,2,27,6,5.778996565,33.3968013,25,1500.372543
85,108,193,4,4,3,26,4,5.778996565,33.3968013,23,1491.332211
86,107,193,4,4,4,25,6,5.778996565,33.3968013,21,1481.439629
76,118,194,3,4,26,36,9,5.788960372,33.51206219,42,1538.812501
77,117,194,3,4,27,35,2,5.788960372,33.51206219,40,1538.126769
78,116,194,3,4,28,34,9,5.788960372,33.51206219,38,1539.572748
79,115,194,3,4,29,33,2,5.788960372,33.51206219,36,1536.242234
80,114,194,3,4,30,32,9,5.788960372,33.51206219,34,1535.431896
81,113,194,3,4,31,31,2,5.788960372,33.51206219,32,1529.403093
82,112,194,4,4,0,30,9,5.788960372,33.51206219,30,1525.891111
83,111,194,4,4,1,29,2,5.788960372,33.51206219,28,1516.923927
84,110,194,4,4,2,28,9,5.788960372,33.51206219,26,1511.123172
85,109,194,4,4,3,27,2,5.788960372,33.51206219,24,1500.052698
86,108,194,4,4,4,26,9,5.788960372,33.51206219,22,1492.829243
76,119,195,3,4,26,37,6,5.798889998,33.6271252,43,1543.960256
77,118,195,3,4,27,36,4,5.798889998,33.6271252,41,1545.35862
78,117,195,3,4,28,35,6,5.798889998,33.6271252,39,1545.677835
79,116,195,3,4,29,34,4,5.798889998,33.6271252,37,1544.668671
80,115,195,3,4,30,33,6,5.798889998,33.6271252,35,1542.33261
81,114,195,3,4,31,32,4,5.798889998,33.6271252,33,1538.692214
82,113,195,4,4,0,31,6,5.798889998,33.6271252,31,1533.492617
83,112,195,4,4,1,30,4,5.798889998,33.6271252,29,1526.997791
84,111,195,4,4,2,29,6,5.798889998,33.6271252,27,1519.306523
85,110,195,4,4,3,28,4,5.798889998,33.6271252,25,1510.877823
86,109,195,4,4,4,27,6,5.798889998,33.6271252,23,1501.5749
76,120,196,3,4,26,38,9,5.808785734,33.7419917,44,1550.7971
77,119,196,3,4,27,37,2,5.808785734,33.7419917,42,1551.173145
78,118,196,3,4,28,36,9,5.808785734,33.7419917,40,1553.599821
79,117,196,3,4,29,35,2,5.808785734,33.7419917,38,1551.311639
80,116,196,3,4,30,34,9,5.808785734,33.7419917,36,1551.21652
81,115,196,3,4,31,33,2,5.808785734,33.7419917,34,1546.10484
82,114,196,4,4,0,32,9,5.808785734,33.7419917,32,1543.17413
83,113,196,4,4,1,31,2,5.808785734,33.7419917,30,1535.052576
84,112,196,4,4,2,30,9,5.808785734,33.7419917,28,1529.729922
85,111,196,4,4,3,29,2,5.808785734,33.7419917,26,1519.39202
86,110,196,4,4,4,28,9,5.808785734,33.7419917,24,1512.721336
77,120,197,3,4,27,38,4,5.818647867,33.85666301,43,1558.073059
78,119,197,3,4,28,37,6,5.818647867,33.85666301,41,1559.446366
79,118,197,3,4,29,36,4,5.818647867,33.85666301,39,1559.383996
80,117,197,3,4,30,35,6,5.818647867,33.85666301,37,1558.002119
81,116,197,3,4,31,34,4,5.818647867,33.85666301,35,1555.033783
82,115,197,4,4,0,33,6,5.818647867,33.85666301,33,1550.642593
83,114,197,4,4,1,32,4,5.818647867,33.85666301,31,1544.802056
84,113,197,4,4,2,31,6,5.818647867,33.85666301,29,1537.725579
85,112,197,4,4,3,30,4,5.818647867,33.85666301,27,1529.905428
86,111,197,4,4,4,29,6,5.818647867,33.85666301,25,1521.257443
87,110,197,4,4,5,28,4,5.818647867,33.85666301,23,1511.731508
78,120,198,3,4,28,38,9,5.828476683,33.97114045,42,1567.001938
79,119,198,3,4,29,37,2,5.828476683,33.97114045,40,1565.896365
80,118,198,3,4,30,36,9,5.828476683,33.97114045,38,1566.487534
81,117,198,3,4,31,35,2,5.828476683,33.97114045,36,1562.279618
82,116,198,4,4,0,34,9,5.828476683,33.97114045,34,1560.035961
83,115,198,4,4,1,33,2,5.828476683,33.97114045,32,1552.560035
84,114,198,4,4,2,32,9,5.828476683,33.97114045,30,1547.877098
85,113,198,4,4,3,31,2,5.828476683,33.97114045,28,1538.330231
86,112,198,4,4,4,30,9,5.828476683,33.97114045,26,1532.069451
87,111,198,4,4,5,29,2,5.828476683,33.97114045,24,1520.479085
77,122,199,3,4,27,40,4,5.838272461,34.08542533,45,1570.350113
78,121,199,3,4,28,39,6,5.838272461,34.08542533,43,1572.557919
79,120,199,3,4,29,38,4,5.838272461,34.08542533,41,1573.480642
80,119,199,3,4,30,37,6,5.838272461,34.08542533,39,1573.150601
81,118,199,3,4,31,36,4,5.838272461,34.08542533,37,1570.881583
82,117,199,4,4,0,35,6,5.838272461,34.08542533,35,1567.271583
83,116,199,4,4,1,34,4,5.838272461,34.08542533,33,1562.055117
84,115,199,4,4,2,33,6,5.838272461,34.08542533,31,1555.713982
85,114,199,4,4,3,32,4,5.838272461,34.08542533,29,1548.516172
86,113,199,4,4,4,31,6,5.838272461,34.08542533,27,1540.470303
87,112,199,4,4,5,30,4,5.838272461,34.08542533,25,1531.35672
78,122,200,3,4,28,40,9,5.848035476,34.19951893,44,1579.83972
79,121,200,3,4,29,39,2,5.848035476,34.19951893,42,1579.6983
80,120,200,3,4,30,38,9,5.848035476,34.19951893,40,1581.17912
81,119,200,3,4,31,37,2,5.848035476,34.19951893,38,1577.94074
82,118,200,4,4,0,36,9,5.848035476,34.19951893,36,1576.36202
83,117,200,4,4,1,35,2,5.848035476,34.19951893,34,1569.69938
84,116,200,4,4,2,34,9,5.848035476,34.19951893,32,1565.48814
85,115,200,4,4,3,33,2,5.848035476,34.19951893,30,1556.75202
86,114,200,4,4,4,32,9,5.848035476,34.19951893,28,1550.98222
87,113,200,4,4,5,31,2,5.848035476,34.19951893,26,1540.06584
78,123,201,3,4,28,41,6,5.857766003,34.31342254,45,1585.052574
79,122,201,3,4,29,40,4,5.857766003,34.31342254,43,1586.930215
80,121,201,3,4,30,39,6,5.857766003,34.31342254,41,1587.409701
81,120,201,3,4,31,38,4,5.857766003,34.31342254,39,1586.145612
82,119,201,4,4,0,37,6,5.857766003,34.31342254,37,1583.453518
83,118,201,4,4,1,36,4,5.857766003,34.31342254,35,1578.829131
84,117,201,4,4,2,35,6,5.857766003,34.31342254,33,1573.138942
85,116,201,4,4,3,34,4,5.857766003,34.31342254,31,1566.624874
86,115,201,4,4,4,33,6,5.857766003,34.31342254,29,1559.160497
87,114,201,4,4,5,32,4,5.857766003,34.31342254,27,1550.682177
88,113,201,4,4,6,31,6,5.857766003,34.31342254,25,1541.551571
78,124,202,3,4,28,42,9,5.867464308,34.42713741,46,1592.075302
79,123,202,3,4,29,41,2,5.867464308,34.42713741,44,1592.95382
80,122,202,3,4,30,40,9,5.867464308,34.42713741,42,1595.163801
81,121,202,3,4,31,39,2,5.867464308,34.42713741,40,1593.016561
82,120,202,4,4,0,38,9,5.867464308,34.42713741,38,1592.194401
83,119,202,4,4,1,37,2,5.867464308,34.42713741,36,1586.222311
84,118,202,4,4,2,36,9,5.867464308,34.42713741,34,1582.630671
85,117,202,4,4,3,35,2,5.867464308,34.42713741,32,1574.501867
86,116,202,4,4,4,34,9,5.867464308,34.42713741,30,1569.398964
87,115,202,4,4,5,33,2,5.867464308,34.42713741,28,1559.240525
88,114,202,4,4,6,32,9,5.867464308,34.42713741,26,1552.484817
79,124,203,3,4,29,42,4,5.877130659,34.54066479,45,1599.815595
80,123,203,3,4,30,41,6,5.877130659,34.54066479,43,1601.159008
81,122,203,3,4,31,40,4,5.877130659,34.54066479,41,1600.868759
82,121,203,4,4,0,39,6,5.877130659,34.54066479,39,1599.111591
83,120,203,4,4,1,38,4,5.877130659,34.54066479,37,1595.067669
84,119,203,4,4,2,37,6,5.877130659,34.54066479,35,1590.07123
85,118,203,4,4,3,36,4,5.877130659,34.54066479,33,1584.140686
86,117,203,4,4,4,35,6,5.877130659,34.54066479,31,1577.379771
87,116,203,4,4,5,34,4,5.877130659,34.54066479,29,1569.536968
88,115,203,4,4,6,33,6,5.877130659,34.54066479,27,1561.029705
80,124,204,3,4,30,42,9,5.886765317,34.6540059,44,1608.651282
81,123,204,3,4,31,41,2,5.886765317,34.6540059,42,1607.524855
82,122,204,4,4,0,40,9,5.886765317,34.6540059,40,1607.50625
83,121,204,4,4,1,39,2,5.886765317,34.6540059,38,1602.260003
84,120,204,4,4,2,38,9,5.886765317,34.6540059,36,1599.172789
85,119,204,4,4,3,37,2,5.886765317,34.6540059,34,1591.924649
86,118,204,4,4,4,36,9,5.886765317,34.6540059,32,1587.237157
87,117,204,4,4,5,35,2,5.886765317,34.6540059,30,1577.877392
88,116,204,4,4,6,34,9,5.886765317,34.6540059,28,1571.641255
80,125,205,3,4,30,43,6,5.89636854,34.76716196,45,1614.320163
81,124,205,3,4,31,42,4,5.89636854,34.76716196,43,1615.070893
82,123,205,4,4,0,41,6,5.89636854,34.76716196,41,1614.237917
83,122,205,4,4,1,40,4,5.89636854,34.76716196,39,1610.750969
84,121,205,4,4,2,39,6,5.89636854,34.76716196,37,1606.424444
85,120,205,4,4,3,38,4,5.89636854,34.76716196,35,1601.105227
86,119,205,4,4,4,37,6,5.89636854,34.76716196,33,1595.048133
87,118,205,4,4,5,36,4,5.89636854,34.76716196,31,1587.865835
88,117,205,4,4,6,35,6,5.89636854,34.76716196,29,1579.969809
89,116,205,4,4,7,34,4,5.89636854,34.76716196,27,1570.88464
80,126,206,3,5,30,0,9,5.905940584,34.88013418,46,1621.049494
81,125,206,3,4,31,43,2,5.905940584,34.88013418,44,1621.574711
82,124,206,4,4,0,42,9,5.905940584,34.88013418,42,1622.324572
83,123,206,4,4,1,41,2,5.905940584,34.88013418,40,1617.784929
84,122,206,4,4,2,40,9,5.905940584,34.88013418,38,1615.163044
85,121,206,4,4,3,39,2,5.905940584,34.88013418,36,1608.631422
86,120,206,4,4,4,38,9,5.905940584,34.88013418,34,1604.54259
87,119,206,4,4,5,37,2,5.905940584,34.88013418,32,1595.874193
88,118,206,4,4,6,36,9,5.905940584,34.88013418,30,1590.279377
89,117,206,4,4,7,35,2,5.905940584,34.88013418,28,1579.577883
80,127,207,3,5,30,1,6,5.9154817,34.99292374,47,1624.662518
81,126,207,3,5,31,0,4,5.9154817,34.99292374,45,1628.427165
82,125,207,4,4,0,43,6,5.9154817,34.99292374,43,1629.062345
83,124,207,4,4,1,42,4,5.9154817,34.99292374,41,1625.882597
84,123,207,4,4,2,41,6,5.9154817,34.99292374,39,1622.191394
85,122,207,4,4,3,40,4,5.9154817,34.99292374,37,1617.490817
86,121,207,4,4,4,39,6,5.9154817,34.99292374,35,1612.115731
87,120,207,4,4,5,38,4,5.9154817,34.99292374,33,1605.547662
88,119,207,4,4,6,37,6,5.9154817,34.99292374,31,1598.402312
89,118,207,4,4,7,36,4,5.9154817,34.99292374,29,1589.987721
80,128,208,3,5,30,2,9,5.924992137,35.10553182,48,1629.511811
81,127,208,3,5,31,1,2,5.924992137,35.10553182,46,1632.214168
82,126,208,4,5,0,0,9,5.924992137,35.10553182,44,1636.430224
83,125,208,4,4,1,43,2,5.924992137,35.10553182,42,1632.769507
84,124,208,4,4,2,42,9,5.924992137,35.10553182,40,1630.586214
85,123,208,4,4,3,41,2,5.924992137,35.10553182,38,1624.804563
86,122,208,4,4,4,40,9,5.924992137,35.10553182,36,1621.207702
87,121,208,4,4,5,39,2,5.924992137,35.10553182,34,1613.434888
88,120,208,4,4,6,38,9,5.924992137,35.10553182,32,1608.259682
89,119,208,4,4,7,37,2,5.924992137,35.10553182,30,1598.444411
90,118,208,4,4,8,36,9,5.924992137,35.10553182,28,1591.734893
81,128,209,3,5,31,2,4,5.93447214,35.21795959,47,1637.180161
82,127,209,4,5,0,1,6,5.93447214,35.21795959,45,1640.367599
83,126,209,4,5,1,0,4,5.93447214,35.21795959,43,1640.229262
84,125,209,4,4,2,43,6,5.93447214,35.21795959,41,1637.554334
85,124,209,4,4,3,42,4,5.93447214,35.21795959,39,1633.289752
86,123,209,4,4,4,41,6,5.93447214,35.21795959,37,1628.56468
87,122,209,4,4,5,40,4,5.93447214,35.21795959,35,1622.623437
88,121,209,4,4,6,39,6,5.93447214,35.21795959,33,1616.200699
89,120,209,4,4,7,38,4,5.93447214,35.21795959,31,1608.43171
81,129,210,3,5,31,3,2,5.943921953,35.33020818,48,1640.85369
82,128,210,4,5,0,2,9,5.943921953,35.33020818,46,1645.552776
83,127,210,4,5,1,1,2,5.943921953,35.33020818,44,1644.833904
84,126,210,4,5,2,0,9,5.943921953,35.33020818,42,1645.212702
85,125,210,4,4,3,43,2,5.943921953,35.33020818,40,1640.449398
86,124,210,4,4,4,42,9,5.943921953,35.33020818,38,1637.299713
87,123,210,4,4,5,41,2,5.943921953,35.33020818,36,1630.256103
88,122,210,4,4,6,40,9,5.943921953,35.33020818,34,1625.687427
89,121,210,4,4,7,39,2,5.943921953,35.33020818,32,1616.583822
90,120,210,4,4,8,38,9,5.943921953,35.33020818,30,1610.506044
81,130,211,3,5,31,4,4,5.953341813,35.44227874,49,1645.756007
82,129,211,4,5,0,3,6,5.953341813,35.44227874,47,1649.388667
83,128,211,4,5,1,2,4,5.953341813,35.44227874,45,1649.97242
84,127,211,4,5,2,1,6,5.953341813,35.44227874,43,1649.763466
85,126,211,4,5,3,0,4,5.953341813,35.44227874,41,1648.1958
86,125,211,4,4,4,43,6,5.953341813,35.44227874,39,1644.521593
87,124,211,4,4,5,42,4,5.953341813,35.44227874,37,1639.124234
88,123,211,4,4,6,41,6,5.953341813,35.44227874,35,1633.369716
89,122,211,4,4,7,40,4,5.953341813,35.44227874,33,1626.275748
90,121,211,4,4,8,39,6,5.953341813,35.44227874,31,1618.760477
91,120,211,4,4,9,38,4,5.953341813,35.44227874,29,1609.802303
82,130,212,4,5,0,4,9,5.962731958,35.5541724,48,1654.515904
83,129,212,4,5,1,3,2,5.962731958,35.5541724,46,1654.302568
84,128,212,4,5,2,2,9,5.962731958,35.5541724,44,1655.771686
85,127,212,4,5,3,1,2,5.962731958,35.5541724,42,1653.24808
86,126,212,4,5,4,0,9,5.962731958,35.5541724,40,1652.496816
87,125,212,4,4,5,43,2,5.962731958,35.5541724,38,1646.571246
88,124,212,4,4,6,42,9,5.962731958,35.5541724,36,1642.471654
89,123,212,4,4,7,41,2,5.962731958,35.5541724,34,1634.190955
90,122,212,4,4,8,40,9,5.962731958,35.5541724,32,1628.597314
91,121,212,4,4,9,39,2,5.962731958,35.5541724,30,1618.329327
81,132,213,3,5,31,6,4,5.97209262,35.66589026,51,1654.036824
82,131,213,4,5,0,5,6,5.97209262,35.66589026,49,1658.241892
83,130,213,4,5,1,4,4,5.97209262,35.66589026,47,1659.487622
84,129,213,4,5,2,3,6,5.97209262,35.66589026,45,1660.127112
85,128,213,4,5,3,2,4,5.97209262,35.66589026,43,1659.270767
86,127,213,4,5,4,1,6,5.97209262,35.66589026,41,1657.604851
87,126,213,4,5,5,0,4,5.97209262,35.66589026,39,1654.680766
88,125,213,4,4,6,43,6,5.97209262,35.66589026,37,1649.998664
89,124,213,4,4,7,42,4,5.97209262,35.66589026,35,1643.42084
90,123,213,4,4,8,41,6,5.97209262,35.66589026,33,1636.659411
91,122,213,4,4,9,40,4,5.97209262,35.66589026,31,1628.342975
82,132,214,4,5,0,6,9,5.98142403,35.77743342,50,1663.292637
83,131,214,4,5,1,5,2,5.98142403,35.77743342,48,1663.528037
84,130,214,4,5,2,4,9,5.98142403,35.77743342,46,1666.014888
85,129,214,4,5,3,3,2,5.98142403,35.77743342,44,1664.141725
86,128,214,4,5,4,2,9,5.98142403,35.77743342,42,1664.299892
87,127,214,4,5,5,1,2,5.98142403,35.77743342,40,1660.15621
88,126,214,4,5,6,0,9,5.98142403,35.77743342,38,1658.322787
89,125,214,4,4,7,43,2,5.98142403,35.77743342,36,1651.199904
90,124,214,4,4,8,42,9,5.98142403,35.77743342,34,1646.155902
91,123,214,4,4,9,41,2,5.98142403,35.77743342,32,1636.608592
82,133,215,4,5,0,7,6,5.990726415,35.88880298,51,1666.838692
83,132,215,4,5,1,6,4,5.990726415,35.88880298,49,1668.769306
84,131,215,4,5,2,5,6,5.990726415,35.88880298,47,1670.158012
85,130,215,4,5,3,4,4,5.990726415,35.88880298,45,1670.090481
86,129,215,4,5,4,3,6,5.990726415,35.88880298,43,1669.220526
87,128,215,4,5,5,2,4,5.990726415,35.88880298,41,1666.951051
88,127,215,4,5,6,1,6,5.990726415,35.88880298,39,1663.954854
89,126,215,4,5,7,0,4,5.990726415,35.88880298,37,1659.673946
90,125,215,4,4,8,43,6,5.990726415,35.88880298,35,1654.000719
91,124,215,4,4,9,42,4,5.990726415,35.88880298,33,1646.33526
92,123,215,4,4,10,41,6,5.990726415,35.88880298,31,1638.468152
83,133,216,4,5,1,7,2,6,36,50,1672.595914
84,132,216,4,5,2,6,9,6,36,48,1675.905228
85,131,216,4,5,3,5,2,6,36,46,1674.648518
86,130,216,4,5,4,4,9,6,36,44,1675.869545
87,129,216,4,5,5,3,2,6,36,42,1672.369481
88,128,216,4,5,6,2,9,6,36,40,1671.266693
89,127,216,4,5,7,1,2,6,36,38,1665.62609
90,126,216,4,5,8,0,9,6,36,36,1662.694927
91,125,216,4,4,9,43,2,6,36,34,1654.38733
92,124,216,4,4,10,42,9,6,36,32,1648.362355
83,134,217,4,5,1,8,4,6.009245007,36.11102555,51,1677.811255
84,133,217,4,5,2,7,6,6.009245007,36.11102555,49,1679.875424
85,132,217,4,5,3,6,4,6.009245007,36.11102555,47,1680.581932
86,131,217,4,5,4,5,6,6.009245007,36.11102555,45,1680.535603
87,130,217,4,5,5,4,4,6.009245007,36.11102555,43,1679.097175
88,129,217,4,5,6,3,6,6.009245007,36.11102555,41,1676.739947
89,128,217,4,5,7,2,4,6.009245007,36.11102555,39,1673.144822
90,127,217,4,5,8,1,6,6.009245007,36.11102555,37,1668.859007
91,126,217,4,5,9,0,4,6.009245007,36.11102555,35,1663.227705
83,135,218,4,5,1,9,2,6.018461655,36.22188069,52,1681.396504
84,134,218,4,5,2,8,9,6.018461655,36.22188069,50,1685.47354
85,133,218,4,5,3,7,2,6.018461655,36.22188069,48,1684.947615
86,132,218,4,5,4,6,9,6.018461655,36.22188069,46,1687.048089
87,131,218,4,5,5,5,2,6.018461655,36.22188069,44,1684.423717
88,130,218,4,5,6,4,9,6.018461655,36.22188069,42,1684.055254
89,129,218,4,5,7,3,2,6.018461655,36.22188069,40,1679.06761
90,128,218,4,5,8,2,9,6.018461655,36.22188069,38,1676.769367
91,127,218,4,5,9,1,2,6.018461655,36.22188069,36,1669.704183
92,126,218,4,5,10,0,9,6.018461655,36.22188069,34,1665.676764
84,135,219,4,5,2,9,6,6.02765016,36.33256645,51,1689.220146
85,134,219,4,5,3,8,4,6.02765016,36.33256645,49,1690.723143
86,133,219,4,5,4,7,6,6.02765016,36.33256645,47,1691.50747
87,132,219,4,5,5,6,4,6.02765016,36.33256645,45,1690.937522
88,131,219,4,5,6,5,6,6.02765016,36.33256645,43,1689.378264
89,130,219,4,5,7,4,4,6.02765016,36.33256645,41,1686.420209
90,129,219,4,5,8,3,6,6.02765016,36.33256645,39,1682.744645
91,128,219,4,5,9,2,4,6.02765016,36.33256645,37,1677.841848
92,127,219,4,5,10,1,6,6.02765016,36.33256645,35,1672.346787
93,126,219,4,5,11,0,4,6.02765016,36.33256645,33,1665.423431
84,136,220,4,5,2,10,9,6.036810737,36.44308387,52,1694.709368
85,135,220,4,5,3,9,2,6.036810737,36.44308387,50,1694.814726
86,134,220,4,5,4,8,9,6.036810737,36.44308387,48,1697.796144
87,133,220,4,5,5,7,2,6.036810737,36.44308387,46,1696.14346
88,132,220,4,5,6,6,9,6.036810737,36.44308387,44,1696.571338
89,131,220,4,5,7,5,2,6.036810737,36.44308387,42,1692.31733
90,130,220,4,5,8,4,9,6.036810737,36.44308387,40,1690.589208
91,129,220,4,5,9,3,2,6.036810737,36.44308387,38,1684.218008
93,127,220,4,5,11,1,2,6.036810737,36.44308387,34,1672.456676
84,137,221,4,5,2,11,6,6.045943596,36.55343397,53,1698.270389
85,136,221,4,5,3,10,4,6.045943596,36.55343397,51,1700.479063
86,135,221,4,5,4,9,6,6.045943596,36.55343397,49,1702.008096
87,134,221,4,5,5,8,4,6.045943596,36.55343397,47,1702.419841
88,133,221,4,5,6,7,6,6.045943596,36.55343397,45,1701.950879
89,132,221,4,5,7,6,4,6.045943596,36.55343397,43,1699.601362
90,131,221,4,5,8,5,6,6.045943596,36.55343397,41,1696.410144
91,130,221,4,5,9,4,4,6.045943596,36.55343397,39,1692.192779
92,129,221,4,5,10,3,6,6.045943596,36.55343397,37,1687.265363
84,138,222,4,5,2,12,9,6.055048947,36.66361774,54,1703.629199
85,137,222,4,5,3,11,2,6.055048947,36.66361774,52,1704.380092
86,136,222,4,5,4,10,9,6.055048947,36.66361774,50,1708.1788
87,135,222,4,5,5,9,2,6.055048947,36.66361774,48,1707.390323
88,134,222,4,5,6,8,9,6.055048947,36.66361774,46,1708.665868
89,133,222,4,5,7,7,2,6.055048947,36.66361774,44,1705.581933
90,132,222,4,5,8,6,9,6.055048947,36.66361774,42,1704.218342
91,131,222,4,5,9,5,2,6.055048947,36.66361774,40,1698.574681
92,130,222,4,5,10,4,9,6.055048947,36.66361774,38,1695.583852
93,129,222,4,5,11,3,2,6.055048947,36.66361774,36,1687.799689
85,138,223,4,5,3,12,4,6.064126995,36.77363621,53,1709.976421
86,137,223,4,5,4,11,6,6.064126995,36.77363621,51,1712.232356
87,136,223,4,5,5,10,4,6.064126995,36.77363621,49,1713.457407
88,135,223,4,5,6,9,6,6.064126995,36.77363621,47,1713.824152
89,134,223,4,5,7,8,4,6.064126995,36.77363621,45,1712.449982
90,133,223,4,5,8,7,6,6.064126995,36.77363621,43,1710.1073
91,132,223,4,5,9,6,4,6.064126995,36.77363621,41,1706.372741
92,131,223,4,5,10,5,6,6.064126995,36.77363621,39,1701.882725
93,130,223,4,5,11,4,4,6.064126995,36.77363621,37,1696.487084
85,139,224,4,5,3,13,2,6.073177944,36.88349034,54,1713.76473
86,138,224,4,5,4,12,9,6.073177944,36.88349034,52,1718.248314
87,137,224,4,5,5,11,2,6.073177944,36.88349034,50,1718.162432
88,136,224,4,5,6,10,9,6.073177944,36.88349034,48,1720.302886
89,135,224,4,5,7,9,2,6.073177944,36.88349034,46,1718.112211
90,134,224,4,5,8,8,9,6.073177944,36.88349034,44,1717.568429
91,133,224,4,5,9,7,2,6.073177944,36.88349034,42,1712.919309
92,132,224,4,5,10,6,9,6.073177944,36.88349034,40,1710.256621
93,131,224,4,5,11,5,2,6.073177944,36.88349034,38,1703.184717
86,139,225,4,5,4,13,6,6.082201996,36.99318111,53,1722.230573
87,138,225,4,5,5,12,4,6.082201996,36.99318111,51,1724.16177
88,137,225,4,5,6,11,6,6.082201996,36.99318111,49,1725.206985
89,136,225,4,5,7,10,4,6.082201996,36.99318111,47,1724.780385
90,135,225,4,5,8,9,6,6.082201996,36.99318111,45,1723.325153
91,134,225,4,5,9,8,4,6.082201996,36.99318111,43,1720.49634
92,133,225,4,5,10,7,6,6.082201996,36.99318111,41,1716.698633
93,132,225,4,5,11,6,4,6.082201996,36.99318111,39,1711.670198
86,140,226,4,5,4,14,9,6.091199349,37.10270951,54,1728.088841
87,139,226,4,5,5,13,2,6.091199349,37.10270951,52,1728.533157
88,138,226,4,5,6,12,9,6.091199349,37.10270951,50,1731.603774
89,137,226,4,5,7,11,2,6.091199349,37.10270951,48,1730.179793
90,136,226,4,5,8,10,9,6.091199349,37.10270951,46,1730.509007
91,135,226,4,5,9,9,2,6.091199349,37.10270951,44,1726.890702
92,134,226,4,5,10,8,9,6.091199349,37.10270951,42,1724.813152
93,133,226,4,5,11,7,2,6.091199349,37.10270951,40,1718.542736
86,141,227,4,5,4,15,6,6.1001702,37.21207647,55,1732.021532
87,140,227,4,5,5,14,4,6.1001702,37.21207647,53,1734.442577
88,139,227,4,5,6,13,6,6.1001702,37.21207647,51,1736.16519
89,138,227,4,5,7,12,4,6.1001702,37.21207647,49,1736.710807
90,137,227,4,5,8,11,6,6.1001702,37.21207647,47,1735.973216
91,136,227,4,5,9,10,4,6.1001702,37.21207647,45,1734.165252
92,135,227,4,5,10,9,6,6.1001702,37.21207647,43,1731.168239
93,134,227,4,5,11,8,4,6.1001702,37.21207647,41,1726.851902
86,142,228,4,5,4,16,9,6.109114744,37.32128296,56,1737.73522
87,141,228,4,5,5,15,2,6.109114744,37.32128296,54,1738.812109
88,140,228,4,5,6,14,9,6.109114744,37.32128296,52,1742.473789
89,139,228,4,5,7,13,2,6.109114744,37.32128296,50,1741.736984
90,138,228,4,5,8,12,9,6.109114744,37.32128296,48,1743.0784
91,137,228,4,5,9,11,2,6.109114744,37.32128296,46,1740.143333
92,136,228,4,5,10,10,9,6.109114744,37.32128296,44,1739.064596
94,134,228,4,5,12,8,9,6.109114744,37.32128296,40,1730.612089
86,143,229,4,5,4,17,6,6.118033173,37.4303299,57,1741.687598
87,142,229,4,5,5,16,4,6.118033173,37.4303299,55,1744.599402
88,141,229,4,5,6,15,6,6.118033173,37.4303299,53,1746.92334
89,140,229,4,5,7,14,4,6.118033173,37.4303299,51,1748.013013
90,139,229,4,5,8,13,6,6.118033173,37.4303299,49,1748.335079
91,138,229,4,5,9,12,4,6.118033173,37.4303299,47,1747.241421
92,137,229,4,5,10,11,6,6.118033173,37.4303299,45,1745.145292
93,136,229,4,5,11,10,4,6.118033173,37.4303299,43,1741.772191
94,135,229,4,5,12,9,6,6.118033173,37.4303299,41,1737.396299
95,134,229,4,5,13,8,4,6.118033173,37.4303299,39,1731.828461
87,143,230,4,5,5,17,2,6.126925675,37.53921823,56,1748.852196
88,142,230,4,5,6,16,9,6.126925675,37.53921823,54,1753.040312
89,141,230,4,5,7,15,2,6.126925675,37.53921823,52,1752.935892
90,140,230,4,5,8,14,9,6.126925675,37.53921823,50,1755.129402
91,139,230,4,5,9,13,2,6.126925675,37.53921823,48,1753.036034
92,138,230,4,5,10,12,9,6.126925675,37.53921823,46,1752.812221
93,137,230,4,5,11,11,2,6.126925675,37.53921823,44,1748.408273
94,136,230,4,5,12,10,9,6.126925675,37.53921823,42,1745.930368
87,144,231,4,5,5,18,4,6.13579244,37.64794886,57,1754.329708
88,143,231,4,5,6,17,6,6.13579244,37.64794886,55,1757.411456
89,142,231,4,5,7,16,4,6.13579244,37.64794886,53,1759.082741
90,141,231,4,5,8,15,6,6.13579244,37.64794886,51,1760.247443
91,140,231,4,5,9,14,4,6.13579244,37.64794886,49,1759.856568
92,139,231,4,5,10,13,6,6.13579244,37.64794886,47,1758.692605
93,138,231,4,5,11,12,4,6.13579244,37.64794886,45,1756.092515
94,137,231,4,5,12,11,6,6.13579244,37.64794886,43,1752.625274
87,145,232,4,5,5,19,2,6.144633651,37.75652271,58,1758.408759
88,144,232,4,5,6,18,9,6.144633651,37.75652271,56,1763.202297
89,143,232,4,5,7,17,2,6.144633651,37.75652271,54,1763.762484
90,142,232,4,5,8,16,9,6.144633651,37.75652271,52,1766.687842
91,141,232,4,5,9,15,2,6.144633651,37.75652271,50,1765.40567
92,140,232,4,5,10,14,9,6.144633651,37.75652271,48,1765.960429
94,138,232,4,5,12,12,9,6.144633651,37.75652271,44,1760.644265
87,146,233,4,5,5,20,4,6.153449494,37.86494067,59,1763.632873
88,145,233,4,5,6,19,6,6.153449494,37.86494067,57,1767.436505
89,144,233,4,5,7,18,4,6.153449494,37.86494067,55,1769.680179
90,143,233,4,5,8,17,6,6.153449494,37.86494067,53,1771.474232
91,142,233,4,5,9,16,4,6.153449494,37.86494067,51,1771.934128
92,141,233,4,5,10,15,6,6.153449494,37.86494067,49,1771.722074
93,140,233,4,5,11,14,4,6.153449494,37.86494067,47,1769.910313
94,139,233,4,5,12,13,6,6.153449494,37.86494067,45,1767.024654
96,137,233,4,5,14,11,6,6.153449494,37.86494067,41,1758.218466
88,146,234,4,5,6,20,9,6.162240148,37.97320364,58,1772.911273
89,145,234,4,5,7,19,2,6.162240148,37.97320364,56,1774.21835
90,144,234,4,5,8,18,9,6.162240148,37.97320364,54,1777.664234
91,143,234,4,5,9,17,2,6.162240148,37.97320364,52,1777.155986
92,142,234,4,5,10,16,9,6.162240148,37.97320364,50,1778.567544
93,141,234,4,5,11,15,2,6.162240148,37.97320364,48,1775.975339
94,140,234,4,5,12,14,9,6.162240148,37.97320364,46,1774.797827
96,138,234,4,5,14,12,9,6.162240148,37.97320364,42,1766.860711
89,146,235,4,5,7,20,4,6.171005793,38.08131249,57,1779.773699
90,145,235,4,5,8,19,6,6.171005793,38.08131249,55,1782.330757
91,144,235,4,5,9,18,4,6.171005793,38.08131249,53,1783.277267
92,143,235,4,5,10,17,6,6.171005793,38.08131249,51,1783.865049
93,142,235,4,5,11,16,4,6.171005793,38.08131249,49,1782.958419
94,141,235,4,5,12,15,6,6.171005793,38.08131249,47,1781.036777
95,140,235,4,5,13,14,4,6.171005793,38.08131249,45,1777.812177
89,147,236,4,5,7,21,2,6.179746606,38.18926811,58,1783.981183
90,146,236,4,5,8,20,9,6.179746606,38.18926811,56,1788.164637
91,145,236,4,5,9,19,2,6.179746606,38.18926811,54,1788.303523
92,144,236,4,5,10,18,9,6.179746606,38.18926811,52,1790.410554
93,143,236,4,5,11,17,2,6.179746606,38.18926811,50,1788.694693
94,142,236,4,5,12,16,9,6.179746606,38.18926811,48,1788.388931
96,140,236,4,5,14,14,9,6.179746606,38.18926811,44,1781.872924
90,147,237,4,5,8,21,6,6.188462762,38.29707136,57,1792.536062
91,146,237,4,5,9,20,4,6.188462762,38.29707136,55,1794.181174
92,145,237,4,5,10,19,6,6.188462762,38.29707136,53,1795.536316
93,144,237,4,5,11,18,4,6.188462762,38.29707136,51,1795.272512
94,143,237,4,5,12,17,6,6.188462762,38.29707136,49,1794.270096
96,141,237,4,5,14,15,6,6.188462762,38.29707136,45,1788.549912
98,139,237,4,5,16,13,6,6.188462762,38.29707136,41,1778.294116
91,147,238,4,5,9,21,2,6.197154435,38.40472309,56,1798.886086
92,146,238,4,5,10,20,9,6.197154435,38.40472309,54,1801.690036
93,145,238,4,5,11,19,2,6.197154435,38.40472309,52,1800.760836
94,144,238,4,5,12,18,9,6.197154435,38.40472309,50,1801.269942
95,143,238,4,5,13,17,2,6.197154435,38.40472309,48,1798.229301
96,142,238,4,5,14,16,9,6.197154435,38.40472309,46,1796.423191
92,147,239,4,5,10,21,6,6.205821795,38.51222415,55,1806.496414
93,146,239,4,5,11,20,4,6.205821795,38.51222415,53,1806.975752
94,145,239,4,5,12,19,6,6.205821795,38.51222415,51,1806.916169
95,144,239,4,5,13,18,4,6.205821795,38.51222415,49,1805.331695
96,143,239,4,5,14,17,6,6.205821795,38.51222415,47,1802.79275
92,148,240,4,5,10,22,9,6.214465012,38.61957538,56,1812.42492
93,147,240,4,5,11,21,2,6.214465012,38.61957538,54,1812.041832
94,146,240,4,5,12,20,9,6.214465012,38.61957538,52,1813.450392
95,145,240,4,5,13,19,2,6.214465012,38.61957538,50,1811.283264
96,144,240,4,5,14,18,9,6.214465012,38.61957538,48,1810.286808
98,142,240,4,5,16,16,9,6.214465012,38.61957538,44,1802.4576
93,148,241,4,5,11,22,4,6.223084253,38.72677762,55,1818.114267
94,147,241,4,5,12,21,6,6.223084253,38.72677762,53,1818.69192
95,146,241,4,5,13,20,4,6.223084253,38.72677762,51,1817.93036
96,145,241,4,5,14,19,6,6.223084253,38.72677762,49,1816.380561
93,149,242,4,5,11,23,2,6.231679684,38.83383169,56,1823.083816
94,148,242,4,5,12,22,9,6.231679684,38.83383169,54,1825.001473
95,147,242,4,5,13,21,2,6.231679684,38.83383169,52,1823.467991
96,146,242,4,5,14,20,9,6.231679684,38.83383169,50,1823.349968
98,144,242,4,5,16,18,9,6.231679684,38.83383169,46,1817.201982
94,149,243,4,5,12,23,6,6.240251469,38.9407384,55,1830.035114
95,148,243,4,5,13,22,4,6.240251469,38.9407384,53,1829.832331
96,147,243,4,5,14,21,6,6.240251469,38.9407384,51,1829.043042
97,146,243,4,5,15,20,4,6.240251469,38.9407384,49,1826.75301
94,150,244,4,5,12,24,9,6.24879977,39.04749856,56,1836.054958
95,149,244,4,5,13,23,2,6.24879977,39.04749856,54,1835.199518
96,148,244,4,5,14,22,9,6.24879977,39.04749856,52,1835.844459
97,147,244,4,5,15,21,2,6.24879977,39.04749856,50,1832.80012
98,146,244,4,5,16,20,9,6.24879977,39.04749856,48,1831.253501
94,151,245,4,5,12,25,6,6.257324746,39.15411297,57,1840.754139
95,150,245,4,5,13,24,4,6.257324746,39.15411297,55,1841.249554
96,149,245,4,5,14,23,6,6.257324746,39.15411297,53,1841.363087
97,148,245,4,5,15,22,4,6.257324746,39.15411297,51,1839.771493
98,147,245,4,5,16,21,6,6.257324746,39.15411297,49,1837.417778
94,152,246,4,5,12,26,9,6.265826556,39.26058243,58,1846.608865
96,150,246,4,5,14,24,9,6.265826556,39.26058243,54,1847.822014
97,149,246,4,5,15,23,2,6.265826556,39.26058243,52,1845.689661
98,148,246,4,5,16,22,9,6.265826556,39.26058243,50,1844.784012
99,147,246,4,5,17,21,2,6.265826556,39.26058243,48,1840.273085
100,146,246,4,5,18,20,9,6.265826556,39.26058243,46,1837.118357
96,151,247,4,5,14,25,6,6.274305357,39.36690772,55,1852.977155
97,150,247,4,5,15,24,4,6.274305357,39.36690772,53,1852.238378
98,149,247,4,5,16,23,6,6.274305357,39.36690772,51,1850.836159
99,148,247,4,5,17,22,4,6.274305357,39.36690772,49,1847.584824
96,152,248,4,5,14,26,9,6.282761305,39.47308961,56,1859.188817
97,151,248,4,5,15,25,2,6.282761305,39.47308961,54,1857.66818
98,150,248,4,5,16,24,9,6.282761305,39.47308961,52,1857.778912
100,148,248,4,5,18,22,9,6.282761305,39.47308961,48,1851.554385
96,153,249,4,5,14,27,6,6.291194552,39.57912889,57,1863.902199
97,152,249,4,5,15,26,4,6.291194552,39.57912889,55,1864.024209
98,151,249,4,5,16,25,6,6.291194552,39.57912889,53,1863.365455
100,149,249,4,5,18,23,6,6.291194552,39.57912889,49,1858.00436
101,148,249,4,5,19,22,4,6.291194552,39.57912889,47,1853.560208
96,154,250,4,5,14,28,9,6.299605249,39.6850263,58,1869.734625
97,153,250,4,5,15,27,2,6.299605249,39.6850263,56,1868.98985
98,152,250,4,5,16,26,9,6.299605249,39.6850263,54,1869.989175
100,150,250,4,5,18,24,9,6.299605249,39.6850263,50,1865.522625
101,149,250,4,5,19,23,2,6.299605249,39.6850263,48,1860.413325
96,155,251,4,5,14,29,6,6.307993549,39.79078261,59,1874.147548
97,154,251,4,5,15,28,4,6.307993549,39.79078261,57,1874.785189
98,153,251,4,5,16,27,6,6.307993549,39.79078261,55,1875.095851
99,152,251,4,5,17,26,4,6.307993549,39.79078261,53,1873.936934
100,151,251,4,5,18,25,6,6.307993549,39.79078261,51,1871.707326
101,150,251,4,5,19,24,4,6.307993549,39.79078261,49,1867.917026
98,154,252,4,5,16,28,9,6.316359598,39.89639857,56,1881.267545
99,153,252,4,5,17,27,2,6.316359598,39.89639857,54,1879.225186
100,152,252,4,5,18,26,9,6.316359598,39.89639857,52,1878.920845
101,151,252,4,5,19,25,2,6.316359598,39.89639857,50,1874.487989
102,150,252,4,5,20,24,9,6.316359598,39.89639857,48,1871.301398
98,155,253,4,5,16,29,6,6.324703543,40.00187491,57,1886.071914
99,154,253,4,5,17,28,4,6.324703543,40.00187491,55,1885.580639
100,153,253,4,5,18,27,6,6.324703543,40.00187491,53,1884.463214
102,151,253,4,5,20,25,6,6.324703543,40.00187491,49,1877.885391
103,150,253,4,5,21,24,4,6.324703543,40.00187491,47,1872.938254
98,156,254,4,5,16,30,9,6.333025531,40.10721238,58,1892.103379
99,155,254,4,5,17,29,2,6.333025531,40.10721238,56,1890.668279
100,154,254,4,5,18,28,9,6.333025531,40.10721238,54,1890.977574
102,152,254,4,5,20,26,9,6.333025531,40.10721238,50,1885.592089
103,151,254,4,5,21,25,2,6.333025531,40.10721238,48,1879.887172
99,156,255,4,5,17,30,4,6.341325705,40.2124117,57,1896.644508
100,155,255,4,5,18,29,6,6.341325705,40.2124117,55,1896.15093
101,154,255,4,5,19,28,4,6.341325705,40.2124117,53,1894.326992
102,153,255,4,5,20,27,6,6.341325705,40.2124117,51,1891.574777
103,152,255,4,5,21,26,4,6.341325705,40.2124117,49,1887.657059
100,156,256,4,5,18,30,9,6.349604208,40.3174736,56,1902.537933
102,154,256,4,5,20,28,9,6.349604208,40.3174736,52,1898.634982
103,153,256,4,5,21,27,2,6.349604208,40.3174736,50,1893.929088
104,152,256,4,5,22,26,9,6.349604208,40.3174736,48,1890.671334
100,157,257,4,5,18,31,6,6.35786118,40.42239878,57,1907.503909
101,156,257,4,5,19,30,4,6.35786118,40.42239878,55,1906.319217
102,155,257,4,5,20,29,6,6.35786118,40.42239878,53,1904.282286
104,153,257,4,5,22,27,6,6.35786118,40.42239878,49,1897.098262
105,152,257,4,5,23,26,4,6.35786118,40.42239878,47,1892.028012
101,157,258,4,5,19,31,2,6.36609676,40.52718796,56,1911.692667
104,154,258,4,5,22,28,9,6.36609676,40.52718796,50,1904.691631
105,153,258,4,5,23,27,2,6.36609676,40.52718796,48,1898.745917
102,157,259,4,5,20,31,6,6.374311088,40.63184185,55,1916.592593
105,154,259,4,5,23,28,4,6.374311088,40.63184185,49,1906.333913
106,154,260,4,5,24,28,9,6.382504299,40.73636112,48,1909.066432
104,157,261,4,5,22,31,6,6.390676528,40.84074649,53,1923.931694
106,155,261,4,5,24,29,6,6.390676528,40.84074649,49,1915.680231
107,154,261,4,5,25,28,4,6.390676528,40.84074649,47,1909.823469
106,156,262,4,5,24,30,9,6.39882791,40.94499863,50,1923.387483
107,155,262,4,5,25,29,2,6.39882791,40.94499863,48,1916.722072
108,156,264,4,5,26,30,9,6.41506866,41.15310591,48,1926.771317
108,157,265,4,5,26,31,6,6.423158289,41.2569624,49,1933.505561
108,158,266,4,5,26,32,9,6.431227591,41.36068833,50,1941.337453
109,157,266,4,5,27,31,2,6.431227591,41.36068833,48,1934.022107
110,159,269,4,5,28,33,6,6.455314811,41.67108931,49,1950.291722
110,160,270,4,5,28,34,9,6.46330407,41.7742995,50,1958.516118
